date,district,cumulative_under_observation,cumulative_under_home_isolation,cumulative_hospitalized,new_hospitalized
17-08-2020,Thiruvananthapuram,23147,20287,2860,286
17-08-2020,Kollam,8114,7349,765,81
17-08-2020,Pathanamthitta,5080,4776,304,58
17-08-2020,Alappuzha,4195,3930,265,29
17-08-2020,Kottayam,10202,9604,598,107
17-08-2020,Idukki,7547,6157,1390,86
17-08-2020,Ernakulam,15015,13906,1109,73
17-08-2020,Thrissur,9135,8512,623,148
17-08-2020,Palakkad,13693,12825,868,51
17-08-2020,Malappuram,36233,34431,1802,184
17-08-2020,Kozhikode,14720,13372,1348,249
17-08-2020,Wayanad,2761,2374,387,29
17-08-2020,Kannur,9079,8536,543,46
17-08-2020,Kasaragod,5108,4273,835,28
17-08-2020,total,164029,150332,13697,1455
18-08-2020,Thiruvananthapuram,22553,19741,2812,338
18-08-2020,Kollam,8537,7704,833,76
18-08-2020,Pathanamthitta,5386,5087,299,31
18-08-2020,Alappuzha,4270,4041,229,26
18-08-2020,Kottayam,9377,8785,592,91
18-08-2020,Idukki,7705,6287,1418,139
18-08-2020,Ernakulam,15576,14415,1161,157
18-08-2020,Thrissur,8891,8257,634,55
18-08-2020,Palakkad,13768,12880,888,112
18-08-2020,Malappuram,37531,35758,1773,184
18-08-2020,Kozhikode,14922,13606,1316,165
18-08-2020,Wayanad,2784,2424,360,42
18-08-2020,Kannur,9171,8588,583,97
18-08-2020,Kasaragod,5093,4358,735,70
18-08-2020,total,165564,151931,13633,1583
19-08-2020,Thiruvananthapuram,23282,20466,2816,425
19-08-2020,Kollam,8951,8182,769,56
19-08-2020,Pathanamthitta,5267,4922,345,65
19-08-2020,Alappuzha,7700,6242,1458,126
19-08-2020,Kottayam,9667,9036,631,100
19-08-2020,Idukki,4215,3979,236,13
19-08-2020,Ernakulam,17137,15893,1244,225
19-08-2020,Thrissur,9010,8288,722,125
19-08-2020,Palakkad,14142,13295,847,69
19-08-2020,Malappuram,38702,36993,1709,192
19-08-2020,Kozhikode,14720,13408,1312,116
19-08-2020,Wayanad,2634,2263,371,23
19-08-2020,Kannur,9141,8494,647,157
19-08-2020,Kasaragod,5119,4467,652,38
19-08-2020,total,169687,155928,13759,1730
20-08-2020,Thiruvananthapuram,23987,20899,3088,493
20-08-2020,Kollam,9169,8378,791,34
20-08-2020,Pathanamthitta,5390,4979,411,111
20-08-2020,Alappuzha,7926,6294,1632,326
20-08-2020,Kottayam,10322,9529,793,202
20-08-2020,Idukki,4210,3913,297,70
20-08-2020,Ernakulam,16839,15531,1308,178
20-08-2020,Thrissur,9104,8349,755,78
20-08-2020,Palakkad,14084,13279,805,57
20-08-2020,Malappuram,40315,38521,1794,251
20-08-2020,Kozhikode,14850,13678,1172,119
20-08-2020,Wayanad,3053,2666,387,40
20-08-2020,Kannur,9004,8268,736,134
20-08-2020,Kasaragod,4936,4259,677,105
20-08-2020,total,173189,158543,14646,2198
21-08-2020,Thiruvananthapuram,24127,20789,3338,620
21-08-2020,Kollam,9479,8643,836,117
21-08-2020,Pathanamthitta,5493,5001,492,135
21-08-2020,Alappuzha,8663,7007,1656,106
21-08-2020,Kottayam,11004,10185,819,121
21-08-2020,Idukki,4222,3910,312,36
21-08-2020,Ernakulam,17094,15764,1330,151
21-08-2020,Thrissur,9395,8600,795,103
21-08-2020,Palakkad,14093,13337,756,101
21-08-2020,Malappuram,40582,38629,1953,322
21-08-2020,Kozhikode,14837,13698,1139,155
21-08-2020,Wayanad,3300,2932,368,29
21-08-2020,Kannur,9287,8553,734,79
21-08-2020,Kasaragod,5354,4742,612,53
21-08-2020,total,176930,161790,15140,2128
22-08-2020,Thiruvananthapuram,24241,20136,4105,1029
22-08-2020,Kollam,9445,8599,846,36
22-08-2020,Pathanamthitta,5602,5063,539,98
22-08-2020,Alappuzha,9510,7766,1744,155
22-08-2020,Kottayam,12033,11184,849,133
22-08-2020,Idukki,4200,3914,286,24
22-08-2020,Ernakulam,16886,15555,1331,152
22-08-2020,Thrissur,9596,8640,956,221
22-08-2020,Palakkad,13687,12921,766,107
22-08-2020,Malappuram,41539,39515,2024,301
22-08-2020,Kozhikode,14864,13578,1286,248
22-08-2020,Wayanad,3623,3255,368,31
22-08-2020,Kannur,9621,8856,765,103
22-08-2020,Kasaragod,5402,4756,646,61
22-08-2020,total,180249,163738,16511,2699
23-08-2020,Thiruvananthapuram,24787,20841,3946,337
23-08-2020,Kollam,9385,8476,909,90
23-08-2020,Pathanamthitta,5635,5044,591,105
23-08-2020,Alappuzha,9414,7714,1700,87
23-08-2020,Kottayam,12342,11444,898,113
23-08-2020,Idukki,4245,3940,305,38
23-08-2020,Ernakulam,17423,16136,1287,117
23-08-2020,Thrissur,9225,8208,1017,142
23-08-2020,Palakkad,13943,13314,629,105
23-08-2020,Malappuram,42406,40249,2157,412
23-08-2020,Kozhikode,14964,13705,1259,240
23-08-2020,Wayanad,3666,3353,313,13
23-08-2020,Kannur,9754,8944,810,170
23-08-2020,Kasaragod,5336,4628,708,97
23-08-2020,total,182525,165996,16529,2066
25-08-2020,Thiruvananthapuram,24400,20423,3977,427
25-08-2020,Kollam,9617,8701,916,154
25-08-2020,Pathanamthitta,5805,5176,629,23
25-08-2020,Alappuzha,9564,7735,1829,77
25-08-2020,Kottayam,12350,11401,949,90
25-08-2020,Idukki,4255,3991,264,17
25-08-2020,Ernakulam,17410,16029,1381,176
25-08-2020,Thrissur,9365,8317,1048,129
25-08-2020,Palakkad,13892,13334,558,100
25-08-2020,Malappuram,42935,40788,2147,189
25-08-2020,Kozhikode,14963,13532,1431,233
25-08-2020,Wayanad,3712,3415,297,38
25-08-2020,Kannur,10191,9326,865,122
25-08-2020,Kasaragod,5335,4616,719,59
25-08-2020,total,183794,166784,17010,1834
26-08-2020,Thiruvananthapuram,24650,20721,3929,485
26-08-2020,Kollam,13190,12237,953,69
26-08-2020,Pathanamthitta,5762,5052,710,137
26-08-2020,Alappuzha,9730,7795,1935,166
26-08-2020,Kottayam,12088,11112,976,91
26-08-2020,Idukki,4045,3785,260,9
26-08-2020,Ernakulam,17712,16291,1421,154
26-08-2020,Thrissur,9619,8555,1064,131
26-08-2020,Palakkad,13570,12936,634,144
26-08-2020,Malappuram,44577,42315,2262,213
26-08-2020,Kozhikode,15170,13638,1532,220
26-08-2020,Wayanad,3846,3548,298,35
26-08-2020,Kannur,10392,9430,962,178
26-08-2020,Kasaragod,5430,4720,710,66
26-08-2020,total,189781,172135,17646,2098
27-08-2020,Thiruvananthapuram,24727,20870,3857,432
27-08-2020,Kollam,15220,14128,1092,258
27-08-2020,Pathanamthitta,5841,5036,805,180
27-08-2020,Alappuzha,9882,7849,2033,193
27-08-2020,Kottayam,12397,11372,1025,135
27-08-2020,Idukki,4253,3952,301,69
27-08-2020,Ernakulam,18067,16604,1463,171
27-08-2020,Thrissur,9727,8608,1119,163
27-08-2020,Palakkad,12955,12281,674,96
27-08-2020,Malappuram,45343,43103,2240,255
27-08-2020,Kozhikode,15304,13640,1664,270
27-08-2020,Wayanad,3862,3563,299,50
27-08-2020,Kannur,10815,9738,1077,121
27-08-2020,Kasaragod,5532,4769,763,72
27-08-2020,total,193925,175513,18412,2465
28-08-2020,Thiruvananthapuram,24421,20429,3992,502
28-08-2020,Kollam,15209,14076,1133,71
28-08-2020,Pathanamthitta,5796,4879,917,200
28-08-2020,Alappuzha,9514,7407,2107,172
28-08-2020,Kottayam,13124,11996,1128,193
28-08-2020,Idukki,4420,4122,298,34
28-08-2020,Ernakulam,17814,16345,1469,194
28-08-2020,Thrissur,10224,9044,1180,187
28-08-2020,Palakkad,13023,12295,728,156
28-08-2020,Malappuram,45408,43220,2188,290
28-08-2020,Kozhikode,15122,13348,1774,264
28-08-2020,Wayanad,3783,3467,316,27
28-08-2020,Kannur,11089,10008,1081,124
28-08-2020,Kasaragod,5484,4670,814,127
28-08-2020,total,194431,175306,19125,2541
30-08-2020,Thiruvananthapuram,24291,20308,3983,405
30-08-2020,Kollam,15730,14404,1326,194
30-08-2020,Pathanamthitta,5881,5029,852,128
30-08-2020,Alappuzha,9805,7624,2181,174
30-08-2020,Kottayam,14378,13190,1188,138
30-08-2020,Idukki,4627,4343,284,35
30-08-2020,Ernakulam,18064,16554,1510,146
30-08-2020,Thrissur,10076,8754,1322,214
30-08-2020,Palakkad,12743,11880,863,135
30-08-2020,Malappuram,47023,45026,1997,310
30-08-2020,Kozhikode,15391,13517,1874,278
30-08-2020,Wayanad,3236,2987,249,10
30-08-2020,Kannur,12005,10950,1055,106
30-08-2020,Kasaragod,6218,5416,802,105
30-08-2020,total,199468,179982,19486,2378
31-08-2020,Thiruvananthapuram,23571,19708,3863,278
31-08-2020,Kollam,15749,14351,1398,98
31-08-2020,Pathanamthitta,5987,5085,902,156
31-08-2020,Alappuzha,9726,7732,1994,91
31-08-2020,Kottayam,15034,13789,1245,217
31-08-2020,Idukki,4462,4175,287,28
31-08-2020,Ernakulam,18381,16825,1556,143
31-08-2020,Thrissur,10372,9101,1271,105
31-08-2020,Palakkad,11937,11134,803,57
31-08-2020,Malappuram,47282,45302,1980,239
31-08-2020,Kozhikode,15205,13245,1960,185
31-08-2020,Wayanad,3223,2984,239,19
31-08-2020,Kannur,11590,10566,1024,112
31-08-2020,Kasaragod,6324,5480,844,83
31-08-2020,total,198843,179477,19366,1811
01-09-2020,Thiruvananthapuram,22494,18747,3747,200
01-09-2020,Kollam,15073,13644,1429,91
01-09-2020,Pathanamthitta,6106,5177,929,116
01-09-2020,Alappuzha,9791,7757,2034,135
01-09-2020,Kottayam,15603,14346,1257,88
01-09-2020,Idukki,4423,4145,278,9
01-09-2020,Ernakulam,18252,16661,1591,177
01-09-2020,Thrissur,10092,8822,1270,140
01-09-2020,Palakkad,11622,10905,717,68
01-09-2020,Malappuram,47120,45272,1848,145
01-09-2020,Kozhikode,15127,13276,1851,141
01-09-2020,Wayanad,3025,2787,238,23
01-09-2020,Kannur,11468,10416,1052,100
01-09-2020,Kasaragod,6386,5533,853,33
01-09-2020,total,196582,177488,19094,1466
03-09-2020,Thiruvananthapuram,21551,17970,3581,357
03-09-2020,Kollam,15078,13688,1390,33
03-09-2020,Pathanamthitta,6043,5222,821,39
03-09-2020,Alappuzha,9726,8030,1696,157
03-09-2020,Kottayam,14997,13716,1281,148
03-09-2020,Idukki,4375,4145,230,6
03-09-2020,Ernakulam,16102,14550,1552,132
03-09-2020,Thrissur,10319,8954,1365,201
03-09-2020,Palakkad,10733,10132,601,36
03-09-2020,Malappuram,46966,45296,1670,122
03-09-2020,Kozhikode,15017,13182,1835,261
03-09-2020,Wayanad,2977,2730,247,26
03-09-2020,Kannur,11810,10760,1050,139
03-09-2020,Kasaragod,6474,5760,714,46
03-09-2020,total,192168,174135,18033,1703
04-09-2020,Thiruvananthapuram,21465,18008,3457,322
04-09-2020,Kollam,16203,14867,1336,69
04-09-2020,Pathanamthitta,5996,5157,839,126
04-09-2020,Alappuzha,9769,8436,1333,75
04-09-2020,Kottayam,15634,14310,1324,166
04-09-2020,Idukki,4417,4165,252,52
04-09-2020,Ernakulam,18862,17372,1490,132
04-09-2020,Thrissur,10549,9175,1374,166
04-09-2020,Palakkad,10480,9921,559,61
04-09-2020,Malappuram,48284,46731,1553,93
04-09-2020,Kozhikode,15118,13415,1703,233
04-09-2020,Wayanad,2892,2611,281,63
04-09-2020,Kannur,12210,11260,950,103
04-09-2020,Kasaragod,6058,5315,743,89
04-09-2020,total,197937,180743,17194,1750
05-09-2020,Thiruvananthapuram,21574,18037,3537,506
05-09-2020,Kollam,14522,13284,1238,162
05-09-2020,Pathanamthitta,5978,5118,860,177
05-09-2020,Alappuzha,9575,8409,1166,105
05-09-2020,Kottayam,16289,14915,1374,185
05-09-2020,Idukki,4578,4357,221,34
05-09-2020,Ernakulam,19663,18009,1654,277
05-09-2020,Thrissur,10838,9399,1439,186
05-09-2020,Palakkad,10302,9795,507,66
05-09-2020,Malappuram,48652,47252,1400,181
05-09-2020,Kozhikode,14897,13209,1688,265
05-09-2020,Wayanad,2908,2618,290,41
05-09-2020,Kannur,12363,11373,990,188
05-09-2020,Kasaragod,5981,5123,858,150
05-09-2020,total,198120,180898,17222,2523
06-09-2020,Thiruvananthapuram,22300,18790,3510,576
06-09-2020,Kollam,15550,14307,1243,174
06-09-2020,Pathanamthitta,6007,5080,927,167
06-09-2020,Alappuzha,9705,8435,1270,130
06-09-2020,Kottayam,16630,15283,1347,119
06-09-2020,Idukki,4767,4533,234,35
06-09-2020,Ernakulam,20357,18646,1711,208
06-09-2020,Thrissur,10048,8607,1441,165
06-09-2020,Palakkad,10378,9860,518,108
06-09-2020,Malappuram,48142,46711,1431,149
06-09-2020,Kozhikode,15200,13523,1677,228
06-09-2020,Wayanad,2637,2348,289,32
06-09-2020,Kannur,12471,11400,1071,188
06-09-2020,Kasaragod,6104,5266,838,131
06-09-2020,total,200296,182789,17507,2410
07-09-2020,Thiruvananthapuram,22804,19318,3486,308
07-09-2020,Kollam,15889,14628,1261,140
07-09-2020,Pathanamthitta,6015,5109,906,128
07-09-2020,Alappuzha,9317,7855,1462,219
07-09-2020,Kottayam,16764,15370,1394,195
07-09-2020,Idukki,5066,4844,222,21
07-09-2020,Ernakulam,20741,18987,1754,208
07-09-2020,Thrissur,9872,8506,1366,135
07-09-2020,Palakkad,10199,9601,598,155
07-09-2020,Malappuram,46986,45528,1458,201
07-09-2020,Kozhikode,15550,13885,1665,206
07-09-2020,Wayanad,2602,2303,299,29
07-09-2020,Kannur,12842,11625,1217,207
07-09-2020,Kasaragod,6004,4962,1042,233
07-09-2020,total,200651,182521,18130,2385
08-09-2020,Thiruvananthapuram,23009,19559,3450,347
08-09-2020,Kollam,17138,15841,1297,112
08-09-2020,Pathanamthitta,6063,5206,857,48
08-09-2020,Alappuzha,9141,7758,1383,75
08-09-2020,Kottayam,17391,15993,1398,128
08-09-2020,Idukki,5374,5111,263,54
08-09-2020,Ernakulam,20890,19187,1703,159
08-09-2020,Thrissur,9953,8973,980,178
08-09-2020,Palakkad,9785,9144,641,129
08-09-2020,Malappuram,42231,40740,1491,287
08-09-2020,Kozhikode,15782,14088,1694,273
08-09-2020,Wayanad,2462,2168,294,22
08-09-2020,Kannur,13052,11692,1360,203
08-09-2020,Kasaragod,6579,5503,1076,61
08-09-2020,total,198850,180963,17887,2076
09-09-2020,Thiruvananthapuram,23403,19908,3495,432
09-09-2020,Kollam,18315,16869,1446,237
09-09-2020,Pathanamthitta,6143,5265,878,159
09-09-2020,Alappuzha,9120,7670,1450,217
09-09-2020,Kottayam,17967,16508,1459,147
09-09-2020,Idukki,5581,5289,292,55
09-09-2020,Ernakulam,21324,19636,1688,137
09-09-2020,Thrissur,10957,9887,1070,279
09-09-2020,Palakkad,9830,9107,723,156
09-09-2020,Malappuram,42284,40671,1613,258
09-09-2020,Kozhikode,16098,14257,1841,303
09-09-2020,Wayanad,2375,2082,293,25
09-09-2020,Kannur,13120,11649,1471,249
09-09-2020,Kasaragod,6284,5123,1161,97
09-09-2020,total,202801,183921,18880,2751
10-09-2020,Thiruvananthapuram,23406,19801,3605,362
10-09-2020,Kollam,17539,15908,1631,249
10-09-2020,Pathanamthitta,6207,5180,1027,190
10-09-2020,Alappuzha,9137,7530,1607,240
10-09-2020,Kottayam,18641,17109,1532,168
10-09-2020,Idukki,5926,5586,340,65
10-09-2020,Ernakulam,22389,20637,1752,190
10-09-2020,Thrissur,11099,9907,1192,181
10-09-2020,Palakkad,9231,8376,855,167
10-09-2020,Malappuram,42618,40890,1728,258
10-09-2020,Kozhikode,16570,14660,1910,272
10-09-2020,Wayanad,2613,2226,387,107
10-09-2020,Kannur,12832,11360,1472,125
10-09-2020,Kasaragod,6168,4958,1210,117
10-09-2020,total,204376,184128,20248,2691
12-09-2020,Thiruvananthapuram,23841,20058,3783,364
12-09-2020,Kollam,18456,16601,1855,265
12-09-2020,Pathanamthitta,6383,5226,1157,93
12-09-2020,Alappuzha,9554,7753,1801,200
12-09-2020,Kottayam,18873,17115,1758,204
12-09-2020,Idukki,6543,6186,357,27
12-09-2020,Ernakulam,23010,21239,1771,188
12-09-2020,Thrissur,11070,9727,1343,213
12-09-2020,Palakkad,8783,7656,1127,175
12-09-2020,Malappuram,36710,34759,1951,294
12-09-2020,Kozhikode,17375,15212,2163,332
12-09-2020,Wayanad,2896,2406,490,59
12-09-2020,Kannur,13868,12382,1486,122
12-09-2020,Kasaragod,5938,4803,1135,40
12-09-2020,total,203300,181123,22177,2576
13-09-2020,Thiruvananthapuram,24170,20220,3950,549
13-09-2020,Kollam,19975,18151,1824,187
13-09-2020,Pathanamthitta,6560,5514,1046,122
13-09-2020,Alappuzha,9559,7767,1792,162
13-09-2020,Kottayam,19671,17866,1805,158
13-09-2020,Idukki,6801,6387,414,80
13-09-2020,Ernakulam,23278,21437,1841,276
13-09-2020,Thrissur,11161,9795,1366,163
13-09-2020,Palakkad,9373,8151,1222,155
13-09-2020,Malappuram,33795,31703,2092,344
13-09-2020,Kozhikode,18055,15760,2295,242
13-09-2020,Wayanad,2940,2423,517,64
13-09-2020,Kannur,13908,12546,1362,103
13-09-2020,Kasaragod,5243,4130,1113,79
13-09-2020,total,204489,181850,22639,2684
15-09-2020,Thiruvananthapuram,25094,21400,3694,433
15-09-2020,Kollam,21212,19499,1713,142
15-09-2020,Pathanamthitta,6771,5866,905,47
15-09-2020,Alappuzha,9768,7863,1905,106
15-09-2020,Kottayam,20171,18357,1814,101
15-09-2020,Idukki,7041,6576,465,72
15-09-2020,Ernakulam,23482,21652,1830,204
15-09-2020,Thrissur,10871,9440,1431,161
15-09-2020,Palakkad,9329,8067,1262,159
15-09-2020,Malappuram,32617,30416,2201,280
15-09-2020,Kozhikode,19240,16618,2622,409
15-09-2020,Wayanad,2945,2436,509,63
15-09-2020,Kannur,14468,13193,1275,129
15-09-2020,Kasaragod,5132,4131,1001,18
15-09-2020,total,208141,185514,22627,2324
16-09-2020,Thiruvananthapuram,25282,21474,3808,544
16-09-2020,Kollam,22168,20362,1806,249
16-09-2020,Pathanamthitta,6982,6079,903,146
16-09-2020,Alappuzha,10485,8491,1994,335
16-09-2020,Kottayam,20051,18201,1850,156
16-09-2020,Idukki,7376,6881,495,54
16-09-2020,Ernakulam,23829,22076,1753,203
16-09-2020,Thrissur,11018,9593,1425,180
16-09-2020,Palakkad,8546,7183,1363,223
16-09-2020,Malappuram,32851,30515,2336,250
16-09-2020,Kozhikode,19754,17046,2708,355
16-09-2020,Wayanad,2970,2395,575,78
16-09-2020,Kannur,14668,13555,1113,139
16-09-2020,Kasaragod,5057,4107,950,75
16-09-2020,total,211037,187958,23079,2987
17-09-2020,Thiruvananthapuram,25430,21529,3901,454
17-09-2020,Kollam,22080,20384,1696,161
17-09-2020,Pathanamthitta,7180,6137,1043,244
17-09-2020,Alappuzha,11071,8896,2175,316
17-09-2020,Kottayam,20018,18134,1884,155
17-09-2020,Idukki,7360,6869,491,45
17-09-2020,Ernakulam,23595,21742,1853,327
17-09-2020,Thrissur,11130,9677,1453,172
17-09-2020,Palakkad,8701,7244,1457,211
17-09-2020,Malappuram,33926,31482,2444,324
17-09-2020,Kozhikode,20032,17178,2854,441
17-09-2020,Wayanad,3006,2448,558,70
17-09-2020,Kannur,15125,14094,1031,112
17-09-2020,Kasaragod,4941,3945,996,49
17-09-2020,total,213595,189759,23836,3081
19-09-2020,Thiruvananthapuram,25541,21495,4046,523
19-09-2020,Kollam,23933,22207,1726,270
19-09-2020,Pathanamthitta,7417,6471,946,96
19-09-2020,Alappuzha,11476,9069,2407,271
19-09-2020,Kottayam,19927,17924,2003,170
19-09-2020,Idukki,7704,7137,567,117
19-09-2020,Ernakulam,22958,20970,1988,246
19-09-2020,Thrissur,11407,9783,1624,268
19-09-2020,Palakkad,8881,7271,1610,197
19-09-2020,Malappuram,33884,31407,2477,279
19-09-2020,Kozhikode,21113,18065,3048,348
19-09-2020,Wayanad,3223,2598,625,87
19-09-2020,Kannur,15315,14324,991,143
19-09-2020,Kasaragod,4916,3813,1103,55
19-09-2020,total,217695,192534,25161,3070
20-09-2020,Thiruvananthapuram,26519,22530,3989,474
20-09-2020,Kollam,24563,22855,1708,211
20-09-2020,Pathanamthitta,7464,6418,1046,220
20-09-2020,Alappuzha,11953,9497,2456,336
20-09-2020,Kottayam,20681,18381,2300,214
20-09-2020,Idukki,7933,7457,476,38
20-09-2020,Ernakulam,22523,20522,2001,209
20-09-2020,Thrissur,11538,9879,1659,228
20-09-2020,Palakkad,8945,7199,1746,282
20-09-2020,Malappuram,34724,32082,2642,284
20-09-2020,Kozhikode,21630,18498,3132,372
20-09-2020,Wayanad,3372,2733,639,70
20-09-2020,Kannur,15440,14415,1025,150
20-09-2020,Kasaragod,4894,3795,1099,66
20-09-2020,total,222179,196261,25918,3154
21-09-2020,Thiruvananthapuram,26587,22592,3995,494
21-09-2020,Kollam,22085,20482,1603,125
21-09-2020,Pathanamthitta,7557,6431,1126,166
21-09-2020,Alappuzha,12093,9717,2376,122
21-09-2020,Kottayam,20233,18026,2207,217
21-09-2020,Idukki,8300,7769,531,55
21-09-2020,Ernakulam,22263,20191,2072,270
21-09-2020,Thrissur,11463,9717,1746,200
21-09-2020,Palakkad,8577,6831,1746,172
21-09-2020,Malappuram,34929,32440,2489,294
21-09-2020,Kozhikode,21458,18322,3136,297
21-09-2020,Wayanad,3392,2743,649,57
21-09-2020,Kannur,15120,14121,999,110
21-09-2020,Kasaragod,4850,3747,1103,102
21-09-2020,total,218907,193129,25778,2681
23-09-2020,Thiruvananthapuram,26816,22726,4090,421
23-09-2020,Kollam,22250,20419,1831,333
23-09-2020,Pathanamthitta,7696,6662,1034,153
23-09-2020,Alappuzha,12421,9939,2482,401
23-09-2020,Kottayam,19755,17668,2087,132
23-09-2020,Idukki,8165,7575,590,88
23-09-2020,Ernakulam,22600,20441,2159,201
23-09-2020,Thrissur,11562,9736,1826,289
23-09-2020,Palakkad,7763,5987,1776,188
23-09-2020,Malappuram,29586,27021,2565,201
23-09-2020,Kozhikode,21526,18262,3264,428
23-09-2020,Wayanad,3520,2848,672,46
23-09-2020,Kannur,14907,13742,1165,173
23-09-2020,Kasaragod,4062,3114,948,77
23-09-2020,total,212629,186140,26489,3131
24-09-2020,Thiruvananthapuram,26977,22837,4140,497
24-09-2020,Kollam,21629,19811,1818,188
24-09-2020,Pathanamthitta,7770,6650,1120,204
24-09-2020,Alappuzha,12440,9621,2819,487
24-09-2020,Kottayam,19386,17251,2135,162
24-09-2020,Idukki,7851,7254,597,78
24-09-2020,Ernakulam,22596,20372,2224,254
24-09-2020,Thrissur,11233,9256,1977,285
24-09-2020,Palakkad,8146,6279,1867,212
24-09-2020,Malappuram,30356,27791,2565,303
24-09-2020,Kozhikode,22046,18709,3337,402
24-09-2020,Wayanad,3444,2787,657,89
24-09-2020,Kannur,14478,13386,1092,129
24-09-2020,Kasaragod,3966,3194,772,51
24-09-2020,total,212318,185198,27120,3341
25-09-2020,Thiruvananthapuram,27355,23293,4062,324
25-09-2020,Kollam,20718,18865,1853,241
25-09-2020,Pathanamthitta,7862,6690,1172,167
25-09-2020,Alappuzha,12597,9527,3070,446
25-09-2020,Kottayam,19218,17045,2173,214
25-09-2020,Idukki,8495,7855,640,113
25-09-2020,Ernakulam,23957,21647,2310,357
25-09-2020,Thrissur,11313,9263,2050,301
25-09-2020,Palakkad,8167,6274,1893,279
25-09-2020,Malappuram,31718,29356,2362,313
25-09-2020,Kozhikode,22634,19257,3377,335
25-09-2020,Wayanad,3386,2755,631,57
25-09-2020,Kannur,14323,13251,1072,159
25-09-2020,Kasaragod,3948,3187,761,104
25-09-2020,total,215691,188265,27426,3410
26-09-2020,Thiruvananthapuram,28339,24268,4071,471
26-09-2020,Kollam,21056,19094,1962,289
26-09-2020,Pathanamthitta,7957,6879,1078,30
26-09-2020,Alappuzha,13046,9769,3277,544
26-09-2020,Kottayam,20104,17912,2192,185
26-09-2020,Idukki,8717,8079,638,66
26-09-2020,Ernakulam,24737,22303,2434,349
26-09-2020,Thrissur,11585,9392,2193,319
26-09-2020,Palakkad,8615,6723,1892,210
26-09-2020,Malappuram,33076,30773,2303,288
26-09-2020,Kozhikode,23079,19807,3272,374
26-09-2020,Wayanad,3370,2741,629,89
26-09-2020,Kannur,14290,13177,1113,137
26-09-2020,Kasaragod,4359,3530,829,95
26-09-2020,total,222330,194447,27883,3446
27-09-2020,Thiruvananthapuram,29051,24867,4184,646
27-09-2020,Kollam,21452,19359,2093,317
27-09-2020,Pathanamthitta,8036,6921,1115,166
27-09-2020,Alappuzha,13366,10016,3350,408
27-09-2020,Kottayam,20798,18349,2449,226
27-09-2020,Idukki,9385,8755,630,92
27-09-2020,Ernakulam,23924,21356,2568,322
27-09-2020,Thrissur,11891,9586,2305,354
27-09-2020,Palakkad,9057,7202,1855,204
27-09-2020,Malappuram,34387,32017,2370,318
27-09-2020,Kozhikode,23586,20338,3248,360
27-09-2020,Wayanad,3747,3132,615,97
27-09-2020,Kannur,14708,13598,1110,165
27-09-2020,Kasaragod,4443,3565,878,77
27-09-2020,total,227831,199061,28770,3752
28-09-2020,Thiruvananthapuram,29269,25190,4079,356
28-09-2020,Kollam,19887,17825,2062,158
28-09-2020,Pathanamthitta,8004,6880,1124,173
28-09-2020,Alappuzha,13817,10387,3430,476
28-09-2020,Kottayam,20604,18032,2572,238
28-09-2020,Idukki,9547,8891,656,65
28-09-2020,Ernakulam,25297,22604,2693,340
28-09-2020,Thrissur,12016,9688,2328,285
28-09-2020,Palakkad,9707,7873,1834,209
28-09-2020,Malappuram,36689,34129,2560,356
28-09-2020,Kozhikode,23968,20876,3092,324
28-09-2020,Wayanad,3799,3178,621,74
28-09-2020,Kannur,15168,14006,1162,129
28-09-2020,Kasaragod,4678,3771,907,72
28-09-2020,total,232450,203330,29120,3255
30-09-2020,Thiruvananthapuram,28588,24459,4129,409
30-09-2020,Kollam,20266,18227,2039,286
30-09-2020,Pathanamthitta,8147,7171,976,34
30-09-2020,Alappuzha,13945,10546,3399,510
30-09-2020,Kottayam,21165,18518,2647,179
30-09-2020,Idukki,10232,9532,700,57
30-09-2020,Ernakulam,26687,23896,2791,329
30-09-2020,Thrissur,12334,9788,2546,328
30-09-2020,Palakkad,11589,9900,1689,194
30-09-2020,Malappuram,39283,36830,2453,216
30-09-2020,Kozhikode,24711,21454,3257,470
30-09-2020,Wayanad,3853,3106,747,128
30-09-2020,Kannur,15672,14501,1171,185
30-09-2020,Kasaragod,4412,3366,1046,143
30-09-2020,total,240884,211294,29590,3468
01-10-2020,Thiruvananthapuram,28338,24216,4122,375
01-10-2020,Kollam,19519,17456,2063,161
01-10-2020,Pathanamthitta,8232,7191,1041,130
01-10-2020,Alappuzha,13984,10552,3432,335
01-10-2020,Kottayam,20613,17828,2785,250
01-10-2020,Idukki,10927,10221,706,73
01-10-2020,Ernakulam,26328,23429,2899,237
01-10-2020,Thrissur,12485,9817,2668,345
01-10-2020,Palakkad,12632,10852,1780,226
01-10-2020,Malappuram,40634,38231,2403,167
01-10-2020,Kozhikode,25360,22124,3236,507
01-10-2020,Wayanad,3917,3112,805,115
01-10-2020,Kannur,15707,14466,1241,133
01-10-2020,Kasaragod,4431,3354,1077,96
01-10-2020,total,243107,212849,30258,3150
02-10-2020,Thiruvananthapuram,28493,24394,4099,399
02-10-2020,Kollam,18960,16957,2003,276
02-10-2020,Pathanamthitta,8309,7299,1010,121
02-10-2020,Alappuzha,13997,10083,3914,695
02-10-2020,Kottayam,20099,17275,2824,169
02-10-2020,Idukki,11208,10540,668,49
02-10-2020,Ernakulam,27377,24451,2926,210
02-10-2020,Thrissur,12802,9947,2855,363
02-10-2020,Palakkad,13529,11824,1705,150
02-10-2020,Malappuram,41685,39327,2358,246
02-10-2020,Kozhikode,26235,22858,3377,548
02-10-2020,Wayanad,3774,2946,828,92
02-10-2020,Kannur,15677,14402,1275,147
02-10-2020,Kasaragod,4486,3475,1011,134
02-10-2020,total,246631,215778,30853,3599
03-10-2020,Thiruvananthapuram,28793,24524,4269,581
03-10-2020,Kollam,18389,16517,1872,158
03-10-2020,Pathanamthitta,8326,7277,1049,174
03-10-2020,Alappuzha,13682,9766,3916,344
03-10-2020,Kottayam,20966,18063,2903,336
03-10-2020,Idukki,11401,10804,597,44
03-10-2020,Ernakulam,28863,25945,2918,213
03-10-2020,Thrissur,13004,10234,2770,239
03-10-2020,Palakkad,14298,12554,1744,230
03-10-2020,Malappuram,42100,39736,2364,258
03-10-2020,Kozhikode,27290,23869,3421,480
03-10-2020,Wayanad,3670,2852,818,77
03-10-2020,Kannur,15897,14563,1334,160
03-10-2020,Kasaragod,4607,3514,1093,131
03-10-2020,total,251286,220218,31068,3425
04-10-2020,Thiruvananthapuram,29785,25259,4526,709
04-10-2020,Kollam,19135,17275,1860,207
04-10-2020,Pathanamthitta,8378,7362,1016,125
04-10-2020,Alappuzha,13741,10028,3713,283
04-10-2020,Kottayam,20571,17765,2806,177
04-10-2020,Idukki,11565,11007,558,43
04-10-2020,Ernakulam,29563,26653,2910,258
04-10-2020,Thrissur,13405,10588,2817,342
04-10-2020,Palakkad,15197,13382,1815,288
04-10-2020,Malappuram,44440,42207,2233,202
04-10-2020,Kozhikode,28000,24388,3612,516
04-10-2020,Wayanad,3570,2744,826,90
04-10-2020,Kannur,15811,14411,1400,115
04-10-2020,Kasaragod,4546,3467,1079,43
04-10-2020,total,257707,226536,31171,3398
05-10-2020,Thiruvananthapuram,30226,25847,4379,432
05-10-2020,Kollam,18176,16424,1752,180
05-10-2020,Pathanamthitta,8504,7464,1040,130
05-10-2020,Alappuzha,13092,9504,3588,483
05-10-2020,Kottayam,20184,17504,2680,214
05-10-2020,Idukki,12066,11524,542,55
05-10-2020,Ernakulam,29736,26795,2941,207
05-10-2020,Thrissur,13549,10784,2765,246
05-10-2020,Palakkad,15711,14023,1688,194
05-10-2020,Malappuram,45047,42817,2230,168
05-10-2020,Kozhikode,28791,25193,3598,397
05-10-2020,Wayanad,3653,2871,782,46
05-10-2020,Kannur,15123,13744,1379,151
05-10-2020,Kasaragod,4588,3448,1140,61
05-10-2020,total,258446,227942,30504,2964
06-10-2020,Thiruvananthapuram,30233,25927,4306,375
06-10-2020,Kollam,18339,16714,1625,173
06-10-2020,Pathanamthitta,8557,7532,1025,124
06-10-2020,Alappuzha,13587,10355,3232,112
06-10-2020,Kottayam,19838,17288,2550,172
06-10-2020,Idukki,11924,11429,495,23
06-10-2020,Ernakulam,30767,27891,2876,202
06-10-2020,Thrissur,13562,10821,2741,288
06-10-2020,Palakkad,16645,15043,1602,147
06-10-2020,Malappuram,45723,43551,2172,203
06-10-2020,Kozhikode,30206,26726,3480,345
06-10-2020,Wayanad,3967,3210,757,77
06-10-2020,Kannur,15160,13812,1348,140
06-10-2020,Kasaragod,4586,3404,1182,63
06-10-2020,total,263094,233703,29391,2444
11-10-2020,Thiruvananthapuram,31779,27417,4362,324
11-10-2020,Kollam,20430,18831,1599,207
11-10-2020,Pathanamthitta,8835,7734,1101,137
11-10-2020,Alappuzha,14782,11479,3303,611
11-10-2020,Kottayam,17828,15750,2078,294
11-10-2020,Idukki,12989,12552,437,40
11-10-2020,Ernakulam,33470,30844,2626,406
11-10-2020,Thrissur,14876,12396,2480,368
11-10-2020,Palakkad,18055,16302,1753,140
11-10-2020,Malappuram,52847,50804,2043,267
11-10-2020,Kozhikode,32666,28995,3671,520
11-10-2020,Wayanad,4577,3689,888,113
11-10-2020,Kannur,16460,15357,1103,141
11-10-2020,Kasaragod,5330,4022,1308,90
11-10-2020,total,284924,256172,28752,3658
13-10-2020,Thiruvananthapuram,31304,27115,4189,437
13-10-2020,Kollam,19643,18068,1575,215
13-10-2020,Pathanamthitta,8914,7781,1133,145
13-10-2020,Alappuzha,14509,11970,2539,508
13-10-2020,Kottayam,18355,16459,1896,224
13-10-2020,Idukki,13515,13066,449,47
13-10-2020,Ernakulam,33206,30755,2451,206
13-10-2020,Thrissur,14850,12339,2511,284
13-10-2020,Palakkad,17902,16219,1683,148
13-10-2020,Malappuram,51855,49789,2066,182
13-10-2020,Kozhikode,32043,28474,3569,345
13-10-2020,Wayanad,4487,3701,786,41
13-10-2020,Kannur,16509,15384,1125,92
13-10-2020,Kasaragod,4908,3721,1187,51
13-10-2020,total,282000,254841,27159,2925
14-10-2020,Thiruvananthapuram,31279,27130,4149,270
14-10-2020,Kollam,19389,17787,1602,201
14-10-2020,Pathanamthitta,9007,7934,1073,84
14-10-2020,Alappuzha,14476,12423,2053,88
14-10-2020,Kottayam,18079,16126,1953,325
14-10-2020,Idukki,13689,13230,459,40
14-10-2020,Ernakulam,33476,30991,2485,188
14-10-2020,Thrissur,14581,12157,2424,270
14-10-2020,Palakkad,17787,16247,1540,140
14-10-2020,Malappuram,49888,47793,2095,214
14-10-2020,Kozhikode,32182,28496,3686,456
14-10-2020,Wayanad,4410,3589,821,81
14-10-2020,Kannur,16122,15059,1063,125
14-10-2020,Kasaragod,4624,3683,941,37
14-10-2020,total,278989,252645,26344,2519
15-10-2020,Thiruvananthapuram,30845,26778,4067,292
15-10-2020,Kollam,19015,17425,1590,170
15-10-2020,Pathanamthitta,9106,7998,1108,119
15-10-2020,Alappuzha,14987,13191,1796,208
15-10-2020,Kottayam,17269,15341,1928,194
15-10-2020,Idukki,12837,12382,455,55
15-10-2020,Ernakulam,32054,29573,2481,243
15-10-2020,Thrissur,14460,12037,2423,249
15-10-2020,Palakkad,17986,16509,1477,114
15-10-2020,Malappuram,49232,47164,2068,205
15-10-2020,Kozhikode,31348,27693,3655,462
15-10-2020,Wayanad,4394,3599,795,79
15-10-2020,Kannur,16087,15041,1046,116
15-10-2020,Kasaragod,5052,4270,782,42
15-10-2020,total,274672,249001,25671,2548
16-10-2020,Thiruvananthapuram,30816,26786,4030,296
16-10-2020,Kollam,19340,17798,1542,164
16-10-2020,Pathanamthitta,9172,8200,972,73
16-10-2020,Alappuzha,15527,13425,2102,487
16-10-2020,Kottayam,18119,16106,2013,292
16-10-2020,Idukki,13194,12697,497,45
16-10-2020,Ernakulam,32133,29591,2542,257
16-10-2020,Thrissur,15084,12839,2245,246
16-10-2020,Palakkad,18280,16871,1409,173
16-10-2020,Malappuram,48092,46083,2009,144
16-10-2020,Kozhikode,31425,27944,3481,352
16-10-2020,Wayanad,4430,3695,735,55
16-10-2020,Kannur,16161,15072,1089,128
16-10-2020,Kasaragod,4954,4038,916,64
16-10-2020,total,276727,251145,25582,2776
17-10-2020,Thiruvananthapuram,30399,26637,3762,354
17-10-2020,Kollam,19053,17447,1606,242
17-10-2020,Pathanamthitta,9269,8307,962,156
17-10-2020,Alappuzha,15230,13272,1958,385
17-10-2020,Kottayam,17719,15671,2048,235
17-10-2020,Idukki,12388,11894,494,36
17-10-2020,Ernakulam,32347,29839,2508,236
17-10-2020,Thrissur,15873,13707,2166,273
17-10-2020,Palakkad,18248,16897,1351,143
17-10-2020,Malappuram,49196,47272,1924,221
17-10-2020,Kozhikode,31541,27971,3570,385
17-10-2020,Wayanad,4417,3696,721,96
17-10-2020,Kannur,16386,15311,1075,159
17-10-2020,Kasaragod,4834,4014,820,50
17-10-2020,total,276900,251935,24965,2971
18-10-2020,Thiruvananthapuram,30758,27075,3683,317
18-10-2020,Kollam,20181,18522,1659,181
18-10-2020,Pathanamthitta,9330,8352,978,162
18-10-2020,Alappuzha,15048,13327,1721,131
18-10-2020,Kottayam,17585,15494,2091,233
18-10-2020,Idukki,12330,11956,374,36
18-10-2020,Ernakulam,32962,30416,2546,300
18-10-2020,Thrissur,16390,14240,2150,309
18-10-2020,Palakkad,18615,17263,1352,195
18-10-2020,Malappuram,49033,47098,1935,188
18-10-2020,Kozhikode,31731,28226,3505,436
18-10-2020,Wayanad,4658,3900,758,119
18-10-2020,Kannur,16746,15694,1052,129
18-10-2020,Kasaragod,4869,4133,736,59
18-10-2020,total,280236,255696,24540,2795
19-10-2020,Thiruvananthapuram,30022,26451,3571,380
19-10-2020,Kollam,18968,17392,1576,142
19-10-2020,Pathanamthitta,9386,8412,974,114
19-10-2020,Alappuzha,13968,12507,1461,78
19-10-2020,Kottayam,17019,14872,2147,295
19-10-2020,Idukki,11702,11283,419,82
19-10-2020,Ernakulam,32186,29698,2488,112
19-10-2020,Thrissur,17096,14961,2135,351
19-10-2020,Palakkad,18206,16871,1335,166
19-10-2020,Malappuram,51115,49295,1820,212
19-10-2020,Kozhikode,31267,27835,3432,290
19-10-2020,Wayanad,4957,4274,683,39
19-10-2020,Kannur,16793,15779,1014,81
19-10-2020,Kasaragod,4606,3852,754,53
19-10-2020,total,277291,253482,23809,2395
20-10-2020,Thiruvananthapuram,29646,26195,3451,323
20-10-2020,Kollam,19748,18148,1600,221
20-10-2020,Pathanamthitta,9504,8601,903,71
20-10-2020,Alappuzha,14127,12408,1719,544
20-10-2020,Kottayam,16606,14488,2118,111
20-10-2020,Idukki,12216,11787,429,46
20-10-2020,Ernakulam,32493,30113,2380,201
20-10-2020,Thrissur,17578,15445,2133,307
20-10-2020,Palakkad,18128,16864,1264,101
20-10-2020,Malappuram,54449,52650,1799,189
20-10-2020,Kozhikode,30830,27568,3262,301
20-10-2020,Wayanad,5124,4461,663,61
20-10-2020,Kannur,17235,16239,996,93
20-10-2020,Kasaragod,4535,3780,755,23
20-10-2020,total,282219,258747,23472,2592
21-10-2020,Thiruvananthapuram,29241,25775,3466,327
21-10-2020,Kollam,19316,17677,1639,150
21-10-2020,Pathanamthitta,9654,8774,880,63
21-10-2020,Alappuzha,14181,13023,1158,808
21-10-2020,Kottayam,16503,14320,2183,248
21-10-2020,Idukki,11139,10712,427,26
21-10-2020,Ernakulam,32128,29701,2427,209
21-10-2020,Thrissur,18124,16010,2114,192
21-10-2020,Palakkad,17680,16419,1261,137
21-10-2020,Malappuram,54785,53054,1731,135
21-10-2020,Kozhikode,30131,26914,3217,329
21-10-2020,Wayanad,5468,4766,702,100
21-10-2020,Kannur,17210,16183,1027,146
21-10-2020,Kasaragod,4672,3888,784,29
21-10-2020,total,280232,257216,23016,2899
22-10-2020,Thiruvananthapuram,28779,25505,3274,362
22-10-2020,Kollam,19081,17672,1409,142
22-10-2020,Pathanamthitta,9748,8818,930,126
22-10-2020,Alappuzha,14067,12477,1590,868
22-10-2020,Kottayam,17877,15621,2256,259
22-10-2020,Idukki,10194,9758,436,32
22-10-2020,Ernakulam,31729,29446,2283,217
22-10-2020,Thrissur,18284,16068,2216,344
22-10-2020,Palakkad,17852,16578,1274,121
22-10-2020,Malappuram,55678,53919,1759,179
22-10-2020,Kozhikode,29708,26500,3208,305
22-10-2020,Wayanad,5659,4969,690,58
22-10-2020,Kannur,17439,16383,1056,114
22-10-2020,Kasaragod,4831,4019,812,37
22-10-2020,total,280926,257733,23193,3164
24-10-2020,Thiruvananthapuram,28203,24956,3247,432
24-10-2020,Kollam,18760,17206,1554,264
24-10-2020,Pathanamthitta,9984,9027,957,114
24-10-2020,Alappuzha,13844,12341,1503,508
24-10-2020,Kottayam,18841,16497,2344,403
24-10-2020,Idukki,10160,9737,423,36
24-10-2020,Ernakulam,31923,29616,2307,131
24-10-2020,Thrissur,18624,16300,2324,349
24-10-2020,Palakkad,18039,16725,1314,194
24-10-2020,Malappuram,56234,54572,1662,108
24-10-2020,Kozhikode,29578,26325,3253,644
24-10-2020,Wayanad,5903,5231,672,64
24-10-2020,Kannur,18488,17413,1075,141
24-10-2020,Kasaragod,4936,4116,820,41
24-10-2020,total,283517,260062,23455,3429
25-10-2020,Thiruvananthapuram,28522,25367,3155,378
25-10-2020,Kollam,18147,16633,1514,154
25-10-2020,Pathanamthitta,10094,9141,953,133
25-10-2020,Alappuzha,13675,12335,1340,706
25-10-2020,Kottayam,19081,16739,2342,264
25-10-2020,Idukki,10252,9838,414,48
25-10-2020,Ernakulam,31965,29682,2283,483
25-10-2020,Thrissur,18974,16606,2368,305
25-10-2020,Palakkad,17121,15832,1289,132
25-10-2020,Malappuram,55088,53370,1718,232
25-10-2020,Kozhikode,29784,26669,3115,373
25-10-2020,Wayanad,5993,5341,652,58
25-10-2020,Kannur,18902,17826,1076,115
25-10-2020,Kasaragod,4970,4272,698,58
25-10-2020,total,282568,259651,22917,3439
26-10-2020,Thiruvananthapuram,28375,25325,3050,281
26-10-2020,Kollam,16637,15245,1392,95
26-10-2020,Pathanamthitta,10163,9169,994,167
26-10-2020,Alappuzha,13058,11431,1627,784
26-10-2020,Kottayam,19448,17096,2352,220
26-10-2020,Idukki,10568,10127,441,57
26-10-2020,Ernakulam,31831,29596,2235,310
26-10-2020,Thrissur,19719,17288,2431,329
26-10-2020,Palakkad,16971,15765,1206,111
26-10-2020,Malappuram,57396,55613,1783,212
26-10-2020,Kozhikode,28986,25973,3013,276
26-10-2020,Wayanad,6367,5774,593,28
26-10-2020,Kannur,18974,17913,1061,79
26-10-2020,Kasaragod,4980,4360,620,25
26-10-2020,total,283473,260675,22798,2974
29-10-2020,Thiruvananthapuram,28119,25213,2906,316
29-10-2020,Kollam,18010,16533,1477,122
29-10-2020,Pathanamthitta,10289,9244,1045,55
29-10-2020,Alappuzha,12436,10541,1895,546
29-10-2020,Kottayam,19699,17703,1996,273
29-10-2020,Idukki,11186,10774,412,43
29-10-2020,Ernakulam,32715,30453,2262,172
29-10-2020,Thrissur,22505,19938,2567,424
29-10-2020,Palakkad,16883,15678,1205,155
29-10-2020,Malappuram,61156,59453,1703,233
29-10-2020,Kozhikode,27223,24444,2779,286
29-10-2020,Wayanad,7465,6870,595,62
29-10-2020,Kannur,19537,18368,1169,152
29-10-2020,Kasaragod,4741,4212,529,48
29-10-2020,total,291964,269424,22540,2887
30-10-2020,Thiruvananthapuram,28015,25168,2847,333
30-10-2020,Kollam,16297,14844,1453,102
30-10-2020,Pathanamthitta,10331,9267,1064,121
30-10-2020,Alappuzha,12278,10518,1760,587
30-10-2020,Kottayam,19429,17487,1942,199
30-10-2020,Idukki,11360,10991,369,57
30-10-2020,Ernakulam,32130,29883,2247,98
30-10-2020,Thrissur,23499,20944,2555,312
30-10-2020,Palakkad,16501,15313,1188,114
30-10-2020,Malappuram,59765,58099,1666,202
30-10-2020,Kozhikode,26738,24240,2498,290
30-10-2020,Wayanad,7714,7129,585,69
30-10-2020,Kannur,19885,18867,1018,101
30-10-2020,Kasaragod,4693,4203,490,36
30-10-2020,total,288635,266953,21682,2621
31-10-2020,Thiruvananthapuram,28003,25176,2827,271
31-10-2020,Kollam,17590,16161,1429,141
31-10-2020,Pathanamthitta,10350,9252,1098,119
31-10-2020,Alappuzha,12539,10288,2251,1062
31-10-2020,Kottayam,19686,17671,2015,202
31-10-2020,Idukki,11235,10842,393,44
31-10-2020,Ernakulam,32161,29897,2264,197
31-10-2020,Thrissur,24635,22034,2601,355
31-10-2020,Palakkad,16223,15004,1219,166
31-10-2020,Malappuram,60082,58464,1618,213
31-10-2020,Kozhikode,26449,23910,2539,327
31-10-2020,Wayanad,7963,7339,624,103
31-10-2020,Kannur,19972,18954,1018,94
31-10-2020,Kasaragod,4552,4067,485,35
31-10-2020,total,291440,269059,22381,3329
01-11-2020,Thiruvananthapuram,28443,25663,2780,330
01-11-2020,Kollam,17999,16581,1418,156
01-11-2020,Pathanamthitta,10307,9182,1125,140
01-11-2020,Alappuzha,13165,11324,1841,368
01-11-2020,Kottayam,19155,16863,2292,297
01-11-2020,Idukki,11121,10760,361,27
01-11-2020,Ernakulam,32227,29916,2311,140
01-11-2020,Thrissur,25538,22962,2576,329
01-11-2020,Palakkad,15923,14712,1211,147
01-11-2020,Malappuram,60206,58599,1607,218
01-11-2020,Kozhikode,26537,24003,2534,312
01-11-2020,Wayanad,8401,7787,614,66
01-11-2020,Kannur,19921,18964,957,93
01-11-2020,Kasaragod,4679,4183,496,44
01-11-2020,total,293622,271499,22123,2667
02-11-2020,Thiruvananthapuram,28155,25441,2714,213
02-11-2020,Kollam,16715,15373,1342,85
02-11-2020,Pathanamthitta,10282,9161,1121,122
02-11-2020,Alappuzha,12983,11487,1496,448
02-11-2020,Kottayam,18732,16618,2114,256
02-11-2020,Idukki,11356,10974,382,48
02-11-2020,Ernakulam,31586,29242,2344,261
02-11-2020,Thrissur,26457,23837,2620,346
02-11-2020,Palakkad,16582,15399,1183,141
02-11-2020,Malappuram,60353,58751,1602,186
02-11-2020,Kozhikode,26816,24286,2530,210
02-11-2020,Wayanad,8457,7898,559,15
02-11-2020,Kannur,20209,19256,953,76
02-11-2020,Kasaragod,4538,4021,517,30
02-11-2020,total,293221,271744,21477,2437
04-11-2020,Thiruvananthapuram,28414,25736,2678,326
04-11-2020,Kollam,17178,15761,1417,219
04-11-2020,Pathanamthitta,10145,9276,869,51
04-11-2020,Alappuzha,13296,11977,1319,677
04-11-2020,Kottayam,20222,18005,2217,259
04-11-2020,Idukki,12181,11822,359,35
04-11-2020,Ernakulam,31570,29265,2305,311
04-11-2020,Thrissur,27754,25300,2454,244
04-11-2020,Palakkad,15602,14411,1191,126
04-11-2020,Malappuram,65012,63455,1557,181
04-11-2020,Kozhikode,26902,24317,2585,310
04-11-2020,Wayanad,8914,8290,624,91
04-11-2020,Kannur,20361,19447,914,110
04-11-2020,Kasaragod,4512,4038,474,32
04-11-2020,total,302063,281100,20963,2972
05-11-2020,Thiruvananthapuram,28066,25430,2636,248
05-11-2020,Kollam,18186,16728,1458,167
05-11-2020,Pathanamthitta,10170,9258,912,123
05-11-2020,Alappuzha,13619,12043,1576,778
05-11-2020,Kottayam,19356,17030,2326,301
05-11-2020,Idukki,12783,12398,385,55
05-11-2020,Ernakulam,31126,28841,2285,198
05-11-2020,Thrissur,27781,25227,2554,340
05-11-2020,Palakkad,15406,14219,1187,118
05-11-2020,Malappuram,65675,64178,1497,188
05-11-2020,Kozhikode,26921,24349,2572,305
05-11-2020,Wayanad,9138,8509,629,68
05-11-2020,Kannur,20232,19345,887,86
05-11-2020,Kasaragod,4460,4013,447,36
05-11-2020,total,302919,281568,21351,3011
06-11-2020,Thiruvananthapuram,28250,25702,2548,255
06-11-2020,Kollam,17436,16033,1403,166
06-11-2020,Pathanamthitta,10175,9273,902,88
06-11-2020,Alappuzha,13758,11968,1790,535
06-11-2020,Kottayam,20576,18236,2340,244
06-11-2020,Idukki,13301,12903,398,40
06-11-2020,Ernakulam,30870,28625,2245,264
06-11-2020,Thrissur,27759,25271,2488,291
06-11-2020,Palakkad,15770,14586,1184,82
06-11-2020,Malappuram,69351,67974,1377,216
06-11-2020,Kozhikode,26526,24036,2490,256
06-11-2020,Wayanad,9321,8676,645,95
06-11-2020,Kannur,20218,19361,857,101
06-11-2020,Kasaragod,4517,4036,481,36
06-11-2020,total,307828,286680,21148,2669
07-11-2020,Thiruvananthapuram,28261,25732,2529,284
07-11-2020,Kollam,17586,16165,1421,186
07-11-2020,Pathanamthitta,10158,9260,898,88
07-11-2020,Alappuzha,14096,12503,1593,352
07-11-2020,Kottayam,19583,17574,2009,206
07-11-2020,Idukki,13531,13109,422,74
07-11-2020,Ernakulam,30366,28089,2277,172
07-11-2020,Thrissur,27877,25361,2516,344
07-11-2020,Palakkad,15925,14754,1171,107
07-11-2020,Malappuram,69525,68095,1430,194
07-11-2020,Kozhikode,26725,24219,2506,251
07-11-2020,Wayanad,9542,8882,660,72
07-11-2020,Kannur,19341,18499,842,82
07-11-2020,Kasaragod,4591,4080,511,33
07-11-2020,total,307107,286322,20785,2445
08-11-2020,Thiruvananthapuram,28745,26255,2490,237
08-11-2020,Kollam,18632,17210,1422,67
08-11-2020,Pathanamthitta,10163,9313,850,86
08-11-2020,Alappuzha,14483,13018,1465,343
08-11-2020,Kottayam,20931,18943,1988,275
08-11-2020,Idukki,13903,13452,451,56
08-11-2020,Ernakulam,31730,29405,2325,154
08-11-2020,Thrissur,27739,25270,2469,276
08-11-2020,Palakkad,16359,15188,1171,115
08-11-2020,Malappuram,71115,69873,1242,186
08-11-2020,Kozhikode,27240,24725,2515,261
08-11-2020,Wayanad,9734,9088,646,49
08-11-2020,Kannur,19136,18278,858,109
08-11-2020,Kasaragod,4774,4340,434,5
08-11-2020,total,314684,294358,20326,2219
09-11-2020,Thiruvananthapuram,28486,26100,2386,124
09-11-2020,Kollam,18087,16742,1345,37
09-11-2020,Pathanamthitta,10186,9329,857,102
09-11-2020,Alappuzha,14138,12657,1481,293
09-11-2020,Kottayam,21374,19505,1869,230
09-11-2020,Idukki,14320,13862,458,40
09-11-2020,Ernakulam,32463,30280,2183,193
09-11-2020,Thrissur,27837,25402,2435,286
09-11-2020,Palakkad,16332,15106,1226,147
09-11-2020,Malappuram,71626,70370,1256,186
09-11-2020,Kozhikode,27349,24918,2431,186
09-11-2020,Wayanad,9934,9345,589,33
09-11-2020,Kannur,18989,18082,907,80
09-11-2020,Kasaragod,4975,4510,465,44
09-11-2020,total,316096,296208,19888,1981
10-11-2020,Thiruvananthapuram,27966,25627,2339,242
10-11-2020,Kollam,17931,16634,1297,139
10-11-2020,Pathanamthitta,10198,9405,793,53
10-11-2020,Alappuzha,14300,12884,1416,394
10-11-2020,Kottayam,20908,19018,1890,106
10-11-2020,Idukki,14442,14000,442,37
10-11-2020,Ernakulam,32736,30603,2133,194
10-11-2020,Thrissur,27665,25390,2275,215
10-11-2020,Palakkad,16284,15103,1181,122
10-11-2020,Malappuram,71736,70473,1263,163
10-11-2020,Kozhikode,27691,25320,2371,231
10-11-2020,Wayanad,10137,9586,551,63
10-11-2020,Kannur,18964,18064,900,75
10-11-2020,Kasaragod,5401,4934,467,5
10-11-2020,total,316359,297041,19318,2039
11-11-2020,Thiruvananthapuram,27989,25622,2367,262
11-11-2020,Kollam,18107,16842,1265,112
11-11-2020,Pathanamthitta,10188,9421,767,60
11-11-2020,Alappuzha,14662,13564,1098,160
11-11-2020,Kottayam,20465,18509,1956,214
11-11-2020,Idukki,14409,13967,442,36
11-11-2020,Ernakulam,32628,30561,2067,162
11-11-2020,Thrissur,27680,25378,2302,276
11-11-2020,Palakkad,16160,14988,1172,135
11-11-2020,Malappuram,70725,69378,1347,184
11-11-2020,Kozhikode,27335,24983,2352,254
11-11-2020,Wayanad,10527,9929,598,76
11-11-2020,Kannur,18731,17858,873,75
11-11-2020,Kasaragod,5640,5212,428,22
11-11-2020,total,315246,296212,19034,2028
12-11-2020,Thiruvananthapuram,28002,25709,2293,170
12-11-2020,Kollam,18141,16789,1352,112
12-11-2020,Pathanamthitta,10157,9394,763,89
12-11-2020,Alappuzha,15162,14090,1072,156
12-11-2020,Kottayam,19884,17966,1918,277
12-11-2020,Idukki,14296,13843,453,62
12-11-2020,Ernakulam,32092,30019,2073,121
12-11-2020,Thrissur,27921,25627,2294,263
12-11-2020,Palakkad,16337,15144,1193,120
12-11-2020,Malappuram,71285,70030,1255,194
12-11-2020,Kozhikode,27241,24932,2309,248
12-11-2020,Wayanad,10796,10194,602,50
12-11-2020,Kannur,18453,17662,791,96
12-11-2020,Kasaragod,5816,5374,442,35
12-11-2020,total,315583,296773,18810,1993
13-11-2020,Thiruvananthapuram,27424,25237,2187,175
13-11-2020,Kollam,18507,17269,1238,125
13-11-2020,Pathanamthitta,10153,9365,788,103
13-11-2020,Alappuzha,15417,14126,1291,291
13-11-2020,Kottayam,19441,17532,1909,184
13-11-2020,Idukki,13885,13441,444,29
13-11-2020,Ernakulam,32020,29985,2035,224
13-11-2020,Thrissur,28036,25836,2200,258
13-11-2020,Palakkad,16532,15380,1152,120
13-11-2020,Malappuram,73137,71905,1232,208
13-11-2020,Kozhikode,27052,24886,2166,237
13-11-2020,Wayanad,11209,10639,570,62
13-11-2020,Kannur,18072,17280,792,74
13-11-2020,Kasaragod,6038,5567,471,40
13-11-2020,total,316923,298448,18475,2130
14-11-2020,Thiruvananthapuram,26888,24789,2099,184
14-11-2020,Kollam,18608,17503,1105,176
14-11-2020,Pathanamthitta,10177,9436,741,67
14-11-2020,Alappuzha,15346,13966,1380,389
14-11-2020,Kottayam,19293,17469,1824,170
14-11-2020,Idukki,13918,13483,435,26
14-11-2020,Ernakulam,31773,29789,1984,141
14-11-2020,Thrissur,28199,26061,2138,230
14-11-2020,Palakkad,16618,15495,1123,152
14-11-2020,Malappuram,76490,75276,1214,184
14-11-2020,Kozhikode,26946,24856,2090,284
14-11-2020,Wayanad,11470,10891,579,78
14-11-2020,Kannur,17757,16968,789,74
14-11-2020,Kasaragod,5998,5553,445,25
14-11-2020,total,319481,301535,17946,2180
15-11-2020,Thiruvananthapuram,27352,25274,2078,184
15-11-2020,Kollam,19623,18447,1176,109
15-11-2020,Pathanamthitta,10223,9477,746,82
15-11-2020,Alappuzha,15277,13727,1550,345
15-11-2020,Kottayam,20100,18348,1752,212
15-11-2020,Idukki,13542,13097,445,80
15-11-2020,Ernakulam,31765,29820,1945,137
15-11-2020,Thrissur,28315,26208,2107,224
15-11-2020,Palakkad,15669,14537,1132,117
15-11-2020,Malappuram,78018,76855,1163,138
15-11-2020,Kozhikode,26791,24813,1978,179
15-11-2020,Wayanad,11899,11361,538,59
15-11-2020,Kannur,17653,16890,763,77
15-11-2020,Kasaragod,6069,5609,460,20
15-11-2020,total,322296,304463,17833,1963
17-11-2020,Thiruvananthapuram,27046,25137,1909,142
17-11-2020,Kollam,19279,18192,1087,128
17-11-2020,Pathanamthitta,10257,9526,731,63
17-11-2020,Alappuzha,14593,12924,1669,124
17-11-2020,Kottayam,20449,18800,1649,93
17-11-2020,Idukki,14123,13674,449,31
17-11-2020,Ernakulam,31413,29654,1759,79
17-11-2020,Thrissur,28296,26405,1891,161
17-11-2020,Palakkad,15922,14841,1081,120
17-11-2020,Malappuram,76891,75751,1140,126
17-11-2020,Kozhikode,26063,24287,1776,147
17-11-2020,Wayanad,12276,11767,509,60
17-11-2020,Kannur,17177,16491,686,65
17-11-2020,Kasaragod,6238,5769,469,14
17-11-2020,total,320023,303218,16805,1353
18-11-2020,Thiruvananthapuram,27234,25488,1746,173
18-11-2020,Kollam,18618,17207,1411,444
18-11-2020,Pathanamthitta,10234,9546,688,68
18-11-2020,Alappuzha,14192,12655,1537,136
18-11-2020,Kottayam,20437,18878,1559,223
18-11-2020,Idukki,14374,14011,363,35
18-11-2020,Ernakulam,31094,29513,1581,137
18-11-2020,Thrissur,28307,26416,1891,196
18-11-2020,Palakkad,16132,15042,1090,118
18-11-2020,Malappuram,77159,75990,1169,186
18-11-2020,Kozhikode,25961,24188,1773,207
18-11-2020,Wayanad,11970,11423,547,77
18-11-2020,Kannur,16921,16216,705,82
18-11-2020,Kasaragod,6200,5757,443,29
18-11-2020,total,318833,302330,16503,2111
19-11-2020,Thiruvananthapuram,27247,25523,1724,257
19-11-2020,Kollam,19096,17707,1389,135
19-11-2020,Pathanamthitta,10240,9549,691,103
19-11-2020,Alappuzha,13579,12037,1542,268
19-11-2020,Kottayam,19935,18406,1529,203
19-11-2020,Idukki,14669,14274,395,69
19-11-2020,Ernakulam,30822,29193,1629,208
19-11-2020,Thrissur,28279,26406,1873,211
19-11-2020,Palakkad,16692,15543,1149,123
19-11-2020,Malappuram,77330,76168,1162,143
19-11-2020,Kozhikode,25391,23669,1722,235
19-11-2020,Wayanad,11653,11106,547,57
19-11-2020,Kannur,16766,16069,697,70
19-11-2020,Kasaragod,6326,5897,429,49
19-11-2020,total,318025,301547,16478,2131
21-11-2020,Thiruvananthapuram,27586,25951,1635,147
21-11-2020,Kollam,19703,18318,1385,125
21-11-2020,Pathanamthitta,10205,9474,731,106
21-11-2020,Alappuzha,12226,10686,1540,165
21-11-2020,Kottayam,19640,18143,1497,256
21-11-2020,Idukki,15392,14940,452,58
21-11-2020,Ernakulam,28374,26807,1567,111
21-11-2020,Thrissur,28419,26606,1813,202
21-11-2020,Palakkad,16620,15472,1148,124
21-11-2020,Malappuram,80775,79533,1242,154
21-11-2020,Kozhikode,24683,22998,1685,206
21-11-2020,Wayanad,10995,10396,599,86
21-11-2020,Kannur,16780,16132,648,85
21-11-2020,Kasaragod,6681,6293,388,21
21-11-2020,total,318079,301749,16330,1846
23-11-2020,Thiruvananthapuram,28150,26615,1535,161
23-11-2020,Kollam,19295,17983,1312,73
23-11-2020,Pathanamthitta,10215,9470,745,94
23-11-2020,Alappuzha,11684,10126,1558,198
23-11-2020,Kottayam,19389,17792,1597,212
23-11-2020,Idukki,14512,14054,458,47
23-11-2020,Ernakulam,26192,24625,1567,101
23-11-2020,Thrissur,28582,26869,1713,141
23-11-2020,Palakkad,16319,15193,1126,123
23-11-2020,Malappuram,82490,81182,1308,109
23-11-2020,Kozhikode,23757,22105,1652,171
23-11-2020,Wayanad,10294,9720,574,36
23-11-2020,Kannur,16707,16067,640,58
23-11-2020,Kasaragod,6957,6594,363,27
23-11-2020,total,314543,298395,16148,1551
24-11-2020,Thiruvananthapuram,28124,26608,1516,159
24-11-2020,Kollam,20359,19040,1319,148
24-11-2020,Pathanamthitta,10227,9499,728,60
24-11-2020,Alappuzha,11145,9629,1516,88
24-11-2020,Kottayam,18189,16584,1605,180
24-11-2020,Idukki,14922,14468,454,28
24-11-2020,Ernakulam,26267,24794,1473,61
24-11-2020,Thrissur,28497,26847,1650,160
24-11-2020,Palakkad,15911,14792,1119,131
24-11-2020,Malappuram,84099,82753,1346,199
24-11-2020,Kozhikode,23468,21852,1616,156
24-11-2020,Wayanad,9804,9237,567,58
24-11-2020,Kannur,16783,16171,612,53
24-11-2020,Kasaragod,6957,6628,329,8
24-11-2020,total,314752,298902,15850,1489
25-11-2020,Thiruvananthapuram,28629,27109,1520,178
25-11-2020,Kollam,20278,19019,1259,118
25-11-2020,Pathanamthitta,10238,9536,702,52
25-11-2020,Alappuzha,10860,9508,1352,148
25-11-2020,Kottayam,17039,15335,1704,260
25-11-2020,Idukki,15266,14813,453,30
25-11-2020,Ernakulam,26319,24806,1513,195
25-11-2020,Thrissur,27546,25852,1694,200
25-11-2020,Palakkad,16199,15038,1161,151
25-11-2020,Malappuram,85259,83869,1390,106
25-11-2020,Kozhikode,23303,21619,1684,187
25-11-2020,Wayanad,9485,8816,669,137
25-11-2020,Kannur,16958,16355,603,63
25-11-2020,Kasaragod,7297,6941,356,28
25-11-2020,total,314676,298616,16060,1853
26-11-2020,Thiruvananthapuram,28505,26988,1517,191
26-11-2020,Kollam,19980,18859,1121,162
26-11-2020,Pathanamthitta,10226,9497,729,99
26-11-2020,Alappuzha,10668,9251,1417,187
26-11-2020,Kottayam,17638,15849,1789,242
26-11-2020,Idukki,15456,14981,475,57
26-11-2020,Ernakulam,27030,25518,1512,118
26-11-2020,Thrissur,28442,26699,1743,208
26-11-2020,Palakkad,16301,15088,1213,135
26-11-2020,Malappuram,86131,84714,1417,132
26-11-2020,Kozhikode,23207,21534,1673,174
26-11-2020,Wayanad,9421,8714,707,96
26-11-2020,Kannur,16967,16374,593,66
26-11-2020,Kasaragod,7223,6859,364,24
26-11-2020,total,317195,300925,16270,1891
27-11-2020,Thiruvananthapuram,29024,27486,1538,189
27-11-2020,Kollam,18399,17326,1073,93
27-11-2020,Pathanamthitta,10255,9471,784,116
27-11-2020,Alappuzha,10073,8686,1387,106
27-11-2020,Kottayam,16500,14731,1769,196
27-11-2020,Idukki,15463,14991,472,53
27-11-2020,Ernakulam,27817,26322,1495,94
27-11-2020,Thrissur,28205,26510,1695,231
27-11-2020,Palakkad,15897,14703,1194,123
27-11-2020,Malappuram,85192,83789,1403,114
27-11-2020,Kozhikode,23188,21581,1607,160
27-11-2020,Wayanad,9149,8461,688,43
27-11-2020,Kannur,16903,16319,584,45
27-11-2020,Kasaragod,7543,7155,388,31
27-11-2020,total,313608,297531,16077,1594
28-11-2020,Thiruvananthapuram,30180,28672,1508,166
28-11-2020,Kollam,16523,15472,1051,131
28-11-2020,Pathanamthitta,10263,9475,788,95
28-11-2020,Alappuzha,9797,8457,1340,77
28-11-2020,Kottayam,15574,13814,1760,162
28-11-2020,Idukki,14389,13920,469,47
28-11-2020,Ernakulam,28128,26594,1534,152
28-11-2020,Thrissur,28099,26429,1670,197
28-11-2020,Palakkad,16160,14982,1178,102
28-11-2020,Malappuram,86314,84915,1399,116
28-11-2020,Kozhikode,23177,21569,1608,232
28-11-2020,Wayanad,8913,8148,765,155
28-11-2020,Kannur,16838,16265,573,50
28-11-2020,Kasaragod,7896,7511,385,19
28-11-2020,total,312251,296223,16028,1701
29-11-2020,Thiruvananthapuram,31168,29677,1491,156
29-11-2020,Kollam,16454,15475,979,106
29-11-2020,Pathanamthitta,10286,9475,811,107
29-11-2020,Alappuzha,9837,8573,1264,164
29-11-2020,Kottayam,14513,12651,1862,307
29-11-2020,Idukki,14463,13967,496,67
29-11-2020,Ernakulam,28507,27007,1500,83
29-11-2020,Thrissur,28076,26420,1656,209
29-11-2020,Palakkad,16431,15251,1180,135
29-11-2020,Malappuram,85842,84483,1359,140
29-11-2020,Kozhikode,23473,21837,1636,196
29-11-2020,Wayanad,8358,7609,749,66
29-11-2020,Kannur,19802,19270,532,67
29-11-2020,Kasaragod,8287,7906,381,37
29-11-2020,total,315497,299601,15896,1840
30-11-2020,Thiruvananthapuram,31795,30339,1456,170
30-11-2020,Kollam,16236,15318,918,81
30-11-2020,Pathanamthitta,10309,9474,835,100
30-11-2020,Alappuzha,9727,8402,1325,86
30-11-2020,Kottayam,13123,11235,1888,191
30-11-2020,Idukki,13260,12798,462,51
30-11-2020,Ernakulam,28572,27090,1482,111
30-11-2020,Thrissur,28380,26754,1626,152
30-11-2020,Palakkad,15791,14659,1132,128
30-11-2020,Malappuram,85239,83913,1326,133
30-11-2020,Kozhikode,23463,21853,1610,136
30-11-2020,Wayanad,8244,7543,701,49
30-11-2020,Kannur,19636,19124,512,61
30-11-2020,Kasaragod,7995,7592,403,32
30-11-2020,total,311770,296094,15676,1481
01-12-2020,Thiruvananthapuram,32099,30694,1405,156
01-12-2020,Kollam,15848,14956,892,95
01-12-2020,Pathanamthitta,10327,9548,779,108
01-12-2020,Alappuzha,9501,8233,1268,78
01-12-2020,Kottayam,12373,10597,1776,150
01-12-2020,Idukki,12806,12384,422,17
01-12-2020,Ernakulam,28913,27557,1356,102
01-12-2020,Thrissur,26920,25312,1608,177
01-12-2020,Palakkad,15884,14765,1119,128
01-12-2020,Malappuram,85907,84613,1294,132
01-12-2020,Kozhikode,23572,21981,1591,162
01-12-2020,Wayanad,8743,8002,741,116
01-12-2020,Kannur,19740,19224,516,61
01-12-2020,Kasaragod,7978,7628,350,12
01-12-2020,total,310611,295494,15117,1494
02-12-2020,Thiruvananthapuram,33046,31611,1435,170
02-12-2020,Kollam,15655,14756,899,104
02-12-2020,Pathanamthitta,10351,9556,795,100
02-12-2020,Alappuzha,9389,8204,1185,165
02-12-2020,Kottayam,10631,8712,1919,250
02-12-2020,Idukki,12480,12060,420,30
02-12-2020,Ernakulam,27528,26205,1323,86
02-12-2020,Thrissur,26997,25352,1645,211
02-12-2020,Palakkad,15724,14619,1105,103
02-12-2020,Malappuram,85159,83887,1272,122
02-12-2020,Kozhikode,24508,22922,1586,152
02-12-2020,Wayanad,8733,7918,815,114
02-12-2020,Kannur,21059,20548,511,72
02-12-2020,Kasaragod,8020,7668,352,37
02-12-2020,total,309280,294018,15262,1716
04-12-2020,Thiruvananthapuram,33470,32132,1338,144
04-12-2020,Kollam,14894,14116,778,75
04-12-2020,Pathanamthitta,10365,9439,926,168
04-12-2020,Alappuzha,9322,8077,1245,121
04-12-2020,Kottayam,11307,9513,1794,176
04-12-2020,Idukki,11634,11215,419,53
04-12-2020,Ernakulam,29997,28670,1327,130
04-12-2020,Thrissur,26740,25001,1739,258
04-12-2020,Palakkad,14995,13968,1027,111
04-12-2020,Malappuram,85994,84677,1317,141
04-12-2020,Kozhikode,26294,24761,1533,156
04-12-2020,Wayanad,9495,8657,838,106
04-12-2020,Kannur,21495,21003,492,69
04-12-2020,Kasaragod,8027,7700,327,18
04-12-2020,total,314029,298929,15100,1726
06-12-2020,Thiruvananthapuram,33372,32046,1326,157
06-12-2020,Kollam,14910,14148,762,95
06-12-2020,Pathanamthitta,10420,9527,893,111
06-12-2020,Alappuzha,9223,8046,1177,98
06-12-2020,Kottayam,11434,9688,1746,267
06-12-2020,Idukki,11582,11194,388,21
06-12-2020,Ernakulam,28351,27020,1331,114
06-12-2020,Thrissur,24337,22568,1769,167
06-12-2020,Palakkad,14656,13619,1037,118
06-12-2020,Malappuram,87438,86196,1242,102
06-12-2020,Kozhikode,29058,27499,1559,189
06-12-2020,Wayanad,10198,9303,895,114
06-12-2020,Kannur,21143,20652,491,67
06-12-2020,Kasaragod,8278,7963,315,23
06-12-2020,total,314400,299469,14931,1643
07-12-2020,Thiruvananthapuram,32867,31585,1282,73
07-12-2020,Kollam,14666,13931,735,61
07-12-2020,Pathanamthitta,10450,9531,919,114
07-12-2020,Alappuzha,9034,7765,1269,173
07-12-2020,Kottayam,11276,9610,1666,169
07-12-2020,Idukki,11335,10969,366,86
07-12-2020,Ernakulam,26109,24806,1303,58
07-12-2020,Thrissur,24317,22589,1728,169
07-12-2020,Palakkad,14920,13876,1044,91
07-12-2020,Malappuram,85513,84298,1215,127
07-12-2020,Kozhikode,29989,28495,1494,141
07-12-2020,Wayanad,10695,9901,794,40
07-12-2020,Kannur,21216,20735,481,45
07-12-2020,Kasaragod,7500,7213,287,6
07-12-2020,total,309887,295304,14583,1353
08-12-2020,Thiruvananthapuram,32141,30946,1195,130
08-12-2020,Kollam,14350,13612,738,82
08-12-2020,Pathanamthitta,10341,9412,929,96
08-12-2020,Alappuzha,8932,7717,1215,76
08-12-2020,Kottayam,12392,10794,1598,104
08-12-2020,Idukki,10837,10460,377,52
08-12-2020,Ernakulam,26803,25518,1285,103
08-12-2020,Thrissur,24020,22413,1607,132
08-12-2020,Palakkad,14527,13497,1030,104
08-12-2020,Malappuram,85772,84580,1192,123
08-12-2020,Kozhikode,30650,29215,1435,145
08-12-2020,Wayanad,11240,10445,795,80
08-12-2020,Kannur,20849,20360,489,45
08-12-2020,Kasaragod,7491,7235,256,1
08-12-2020,total,310345,296204,14141,1273
09-12-2020,Thiruvananthapuram,31423,30241,1182,112
09-12-2020,Kollam,14168,13444,724,73
09-12-2020,Pathanamthitta,10250,9352,898,48
09-12-2020,Alappuzha,8588,7494,1094,92
09-12-2020,Kottayam,12689,11020,1669,266
09-12-2020,Idukki,10081,9716,365,10
09-12-2020,Ernakulam,27532,26199,1333,156
09-12-2020,Thrissur,24720,23067,1653,188
09-12-2020,Palakkad,14277,13262,1015,111
09-12-2020,Malappuram,85778,84589,1189,103
09-12-2020,Kozhikode,31279,29834,1445,149
09-12-2020,Wayanad,11567,10746,821,85
09-12-2020,Kannur,20382,19873,509,90
09-12-2020,Kasaragod,7201,6934,267,16
09-12-2020,total,309935,295771,14164,1499
12-12-2020,Thiruvananthapuram,30350,29262,1088,122
12-12-2020,Kollam,14905,14232,673,101
12-12-2020,Pathanamthitta,10010,9074,936,139
12-12-2020,Alappuzha,8397,7262,1135,106
12-12-2020,Kottayam,13058,11429,1629,146
12-12-2020,Idukki,9673,9313,360,54
12-12-2020,Ernakulam,28471,27155,1316,108
12-12-2020,Thrissur,24247,22733,1514,126
12-12-2020,Palakkad,14148,13209,939,59
12-12-2020,Malappuram,86079,85015,1064,142
12-12-2020,Kozhikode,33421,32014,1407,136
12-12-2020,Wayanad,12009,11343,666,27
12-12-2020,Kannur,23454,22916,538,77
12-12-2020,Kasaragod,7422,7145,277,36
12-12-2020,total,315644,302102,13542,1379
13-12-2020,Thiruvananthapuram,28325,27234,1091,136
13-12-2020,Kollam,13684,13004,680,83
13-12-2020,Pathanamthitta,9768,8803,965,150
13-12-2020,Alappuzha,8238,7163,1075,90
13-12-2020,Kottayam,13344,11751,1593,212
13-12-2020,Idukki,9166,8821,345,29
13-12-2020,Ernakulam,31621,30307,1314,174
13-12-2020,Thrissur,24209,22788,1421,164
13-12-2020,Palakkad,13499,12561,938,141
13-12-2020,Malappuram,86794,85725,1069,139
13-12-2020,Kozhikode,35990,34579,1411,203
13-12-2020,Wayanad,11507,10818,689,81
13-12-2020,Kannur,22658,22128,530,63
13-12-2020,Kasaragod,7744,7468,276,15
13-12-2020,total,316547,303150,13397,1680
14-12-2020,Thiruvananthapuram,27217,26145,1072,100
14-12-2020,Kollam,13783,13105,678,66
14-12-2020,Pathanamthitta,9666,8701,965,159
14-12-2020,Alappuzha,8101,6977,1124,105
14-12-2020,Kottayam,12049,10501,1548,185
14-12-2020,Idukki,8953,8619,334,25
14-12-2020,Ernakulam,30330,29021,1309,91
14-12-2020,Thrissur,24069,22637,1432,177
14-12-2020,Palakkad,13363,12459,904,93
14-12-2020,Malappuram,85082,84035,1047,122
14-12-2020,Kozhikode,36085,34740,1345,153
14-12-2020,Wayanad,11362,10731,631,48
14-12-2020,Kannur,22349,21825,524,64
14-12-2020,Kasaragod,7698,7424,274,6
14-12-2020,total,310107,296920,13187,1394
15-12-2020,Thiruvananthapuram,26052,24933,1119,183
15-12-2020,Kollam,14266,13591,675,104
15-12-2020,Pathanamthitta,9607,8589,1018,89
15-12-2020,Alappuzha,7820,6731,1089,88
15-12-2020,Kottayam,11721,10174,1547,125
15-12-2020,Idukki,8621,8249,372,66
15-12-2020,Ernakulam,30508,29188,1320,77
15-12-2020,Thrissur,23960,22659,1301,128
15-12-2020,Palakkad,13062,12138,924,79
15-12-2020,Malappuram,82969,81844,1125,178
15-12-2020,Kozhikode,34738,33469,1269,84
15-12-2020,Wayanad,11526,10890,636,97
15-12-2020,Kannur,21701,21182,519,58
15-12-2020,Kasaragod,7614,7350,264,1
15-12-2020,total,304165,290987,13178,1357
17-12-2020,Thiruvananthapuram,25026,23859,1167,114
17-12-2020,Kollam,13839,13185,654,70
17-12-2020,Pathanamthitta,9533,8481,1052,127
17-12-2020,Alappuzha,7336,6324,1012,118
17-12-2020,Kottayam,12297,10654,1643,260
17-12-2020,Idukki,7878,7496,382,35
17-12-2020,Ernakulam,30451,29098,1353,163
17-12-2020,Thrissur,23697,22319,1378,183
17-12-2020,Palakkad,12486,11617,869,80
17-12-2020,Malappuram,80910,79785,1125,158
17-12-2020,Kozhikode,32521,31285,1236,125
17-12-2020,Wayanad,10848,10158,690,68
17-12-2020,Kannur,23852,23310,542,53
17-12-2020,Kasaragod,6073,5818,255,9
17-12-2020,total,296747,283389,13358,1563
18-12-2020,Thiruvananthapuram,25124,23931,1193,164
18-12-2020,Kollam,13917,13254,663,77
18-12-2020,Pathanamthitta,9511,8403,1108,156
18-12-2020,Alappuzha,7127,6088,1039,116
18-12-2020,Kottayam,12308,10657,1651,170
18-12-2020,Idukki,8005,7605,400,40
18-12-2020,Ernakulam,31318,29917,1401,155
18-12-2020,Thrissur,23447,22125,1322,140
18-12-2020,Palakkad,12116,11263,853,98
18-12-2020,Malappuram,79529,78437,1092,67
18-12-2020,Kozhikode,31766,30541,1225,133
18-12-2020,Wayanad,10706,10050,656,72
18-12-2020,Kannur,23421,22866,555,65
18-12-2020,Kasaragod,6351,6080,271,17
18-12-2020,total,294646,281217,13429,1470
19-12-2020,Thiruvananthapuram,24659,23462,1197,139
19-12-2020,Kollam,13053,12377,676,101
19-12-2020,Pathanamthitta,9517,8385,1132,121
19-12-2020,Alappuzha,7175,6092,1083,129
19-12-2020,Kottayam,12867,11235,1632,205
19-12-2020,Idukki,7955,7540,415,47
19-12-2020,Ernakulam,30119,28744,1375,103
19-12-2020,Thrissur,23351,21999,1352,165
19-12-2020,Palakkad,12042,11226,816,53
19-12-2020,Malappuram,79684,78647,1037,54
19-12-2020,Kozhikode,30804,29506,1298,180
19-12-2020,Wayanad,10502,9810,692,93
19-12-2020,Kannur,22234,21678,556,72
19-12-2020,Kasaragod,5948,5676,272,12
19-12-2020,total,289910,276377,13533,1474
20-12-2020,Thiruvananthapuram,24710,23494,1216,141
20-12-2020,Kollam,13909,13221,688,99
20-12-2020,Pathanamthitta,9482,8308,1174,147
20-12-2020,Alappuzha,7211,6122,1089,116
20-12-2020,Kottayam,13301,11699,1602,131
20-12-2020,Idukki,7991,7590,401,39
20-12-2020,Ernakulam,29257,27826,1431,138
20-12-2020,Thrissur,23236,21844,1392,158
20-12-2020,Palakkad,11936,11110,826,87
20-12-2020,Malappuram,78621,77582,1039,91
20-12-2020,Kozhikode,30055,28842,1213,83
20-12-2020,Wayanad,10389,9631,758,92
20-12-2020,Kannur,20978,20383,595,61
20-12-2020,Kasaragod,6023,5746,277,10
20-12-2020,total,287099,273398,13701,1393
21-12-2020,Thiruvananthapuram,24417,23194,1223,122
21-12-2020,Kollam,14154,13477,677,99
21-12-2020,Pathanamthitta,9458,8295,1163,144
21-12-2020,Alappuzha,7071,5929,1142,136
21-12-2020,Kottayam,12761,11179,1582,232
21-12-2020,Idukki,8084,7699,385,18
21-12-2020,Ernakulam,29693,28259,1434,92
21-12-2020,Thrissur,23301,21900,1401,164
21-12-2020,Palakkad,11816,10976,840,65
21-12-2020,Malappuram,75337,74332,1005,66
21-12-2020,Kozhikode,28820,27600,1220,77
21-12-2020,Wayanad,10389,9717,672,23
21-12-2020,Kannur,19285,18717,568,51
21-12-2020,Kasaragod,5789,5491,298,23
21-12-2020,total,280375,266765,13610,1312
22-12-2020,Thiruvananthapuram,24166,22926,1240,144
22-12-2020,Kollam,14055,13382,673,82
22-12-2020,Pathanamthitta,9470,8332,1138,110
22-12-2020,Alappuzha,7722,6629,1093,59
22-12-2020,Kottayam,13623,11805,1818,368
22-12-2020,Idukki,8234,7848,386,57
22-12-2020,Ernakulam,30919,29520,1399,117
22-12-2020,Thrissur,23348,22049,1299,105
22-12-2020,Palakkad,11644,10844,800,75
22-12-2020,Malappuram,74883,73910,973,68
22-12-2020,Kozhikode,27628,26439,1189,113
22-12-2020,Wayanad,10314,9641,673,78
22-12-2020,Kannur,18007,17438,569,60
22-12-2020,Kasaragod,5698,5415,283,5
22-12-2020,total,279711,266178,13533,1441
23-12-2020,Thiruvananthapuram,24171,22919,1252,133
23-12-2020,Kollam,13952,13135,817,202
23-12-2020,Pathanamthitta,9479,8307,1172,121
23-12-2020,Alappuzha,7571,6654,917,55
23-12-2020,Kottayam,13757,11841,1916,202
23-12-2020,Idukki,8265,7880,385,27
23-12-2020,Ernakulam,30058,28737,1321,93
23-12-2020,Thrissur,23292,21958,1334,176
23-12-2020,Palakkad,11329,10568,761,86
23-12-2020,Malappuram,73918,72942,976,103
23-12-2020,Kozhikode,26745,25588,1157,115
23-12-2020,Wayanad,9760,9035,725,115
23-12-2020,Kannur,16554,15991,563,42
23-12-2020,Kasaragod,5355,5090,265,12
23-12-2020,total,274206,260645,13561,1482
24-12-2020,Thiruvananthapuram,23995,22811,1184,153
24-12-2020,Kollam,13385,12421,964,224
24-12-2020,Pathanamthitta,9493,8311,1182,121
24-12-2020,Alappuzha,7458,6380,1078,199
24-12-2020,Kottayam,14168,12296,1872,166
24-12-2020,Idukki,8248,7881,367,43
24-12-2020,Ernakulam,30530,29202,1328,142
24-12-2020,Thrissur,22962,21615,1347,180
24-12-2020,Palakkad,11465,10707,758,81
24-12-2020,Malappuram,73103,72105,998,122
24-12-2020,Kozhikode,25523,24350,1173,95
24-12-2020,Wayanad,9688,9012,676,56
24-12-2020,Kannur,15480,14947,533,52
24-12-2020,Kasaragod,5227,4975,252,11
24-12-2020,total,270725,257013,13712,1645
25-12-2020,Thiruvananthapuram,23719,22463,1256,200
25-12-2020,Kollam,12831,11853,978,100
25-12-2020,Pathanamthitta,9480,8292,1188,137
25-12-2020,Alappuzha,7258,6138,1120,134
25-12-2020,Kottayam,14363,12505,1858,105
25-12-2020,Idukki,8329,7960,369,29
25-12-2020,Ernakulam,29454,28139,1315,102
25-12-2020,Thrissur,22713,21431,1282,170
25-12-2020,Palakkad,11448,10691,757,81
25-12-2020,Malappuram,71462,70444,1018,80
25-12-2020,Kozhikode,24251,23140,1111,81
25-12-2020,Wayanad,10055,9403,652,81
25-12-2020,Kannur,14696,14173,523,52
25-12-2020,Kasaragod,4925,4667,258,15
25-12-2020,total,264984,251299,13685,1367
26-12-2020,Thiruvananthapuram,23200,21971,1229,89
26-12-2020,Kollam,12895,11961,934,68
26-12-2020,Pathanamthitta,9490,8291,1199,105
26-12-2020,Alappuzha,7007,5959,1048,111
26-12-2020,Kottayam,14171,12317,1854,161
26-12-2020,Idukki,8335,7948,387,35
26-12-2020,Ernakulam,29974,28700,1274,102
26-12-2020,Thrissur,22291,21038,1253,112
26-12-2020,Palakkad,11095,10375,720,41
26-12-2020,Malappuram,70555,69574,981,63
26-12-2020,Kozhikode,22176,21151,1025,64
26-12-2020,Wayanad,9593,8972,621,50
26-12-2020,Kannur,13650,13171,479,51
26-12-2020,Kasaragod,4651,4395,256,9
26-12-2020,total,259083,245823,13260,1061
27-12-2020,Thiruvananthapuram,23133,21884,1249,140
27-12-2020,Kollam,12540,11578,962,65
27-12-2020,Pathanamthitta,9518,8396,1122,127
27-12-2020,Alappuzha,6854,5804,1050,93
27-12-2020,Kottayam,14356,12501,1855,115
27-12-2020,Idukki,8092,7707,385,50
27-12-2020,Ernakulam,29681,28450,1231,90
27-12-2020,Thrissur,21910,20635,1275,147
27-12-2020,Palakkad,10718,10015,703,52
27-12-2020,Malappuram,71007,70047,960,79
27-12-2020,Kozhikode,22097,21066,1031,85
27-12-2020,Wayanad,9557,8959,598,51
27-12-2020,Kannur,12550,12070,480,41
27-12-2020,Kasaragod,4601,4353,248,6
27-12-2020,total,256614,243465,13149,1141
29-12-2020,Thiruvananthapuram,22494,21355,1139,116
29-12-2020,Kollam,12036,11152,884,100
29-12-2020,Pathanamthitta,10204,9171,1033,78
29-12-2020,Alappuzha,7112,6116,996,93
29-12-2020,Kottayam,12694,11227,1467,105
29-12-2020,Idukki,7927,7596,331,26
29-12-2020,Ernakulam,30332,29119,1213,113
29-12-2020,Thrissur,21603,20442,1161,117
29-12-2020,Palakkad,10359,9733,626,79
29-12-2020,Malappuram,68516,67578,938,108
29-12-2020,Kozhikode,21745,20719,1026,89
29-12-2020,Wayanad,9448,8879,569,54
29-12-2020,Kannur,10344,9888,456,46
29-12-2020,Kasaragod,4348,4101,247,6
29-12-2020,total,249162,237076,12086,1130
31-12-2020,Thiruvananthapuram,21438,20252,1186,156
31-12-2020,Kollam,11511,10567,944,107
31-12-2020,Pathanamthitta,10640,9415,1225,160
31-12-2020,Alappuzha,6988,6015,973,88
31-12-2020,Kottayam,12386,10886,1500,201
31-12-2020,Idukki,7828,7525,303,38
31-12-2020,Ernakulam,30592,29334,1258,147
31-12-2020,Thrissur,22119,20924,1195,131
31-12-2020,Palakkad,10056,9480,576,54
31-12-2020,Malappuram,66828,65946,882,96
31-12-2020,Kozhikode,21033,20025,1008,87
31-12-2020,Wayanad,9020,8500,520,37
31-12-2020,Kannur,11626,11171,455,62
31-12-2020,Kasaragod,4220,4013,207,11
31-12-2020,total,246285,234053,12232,1375
01-01-2021,Thiruvananthapuram,20843,19672,1171,122
01-01-2021,Kollam,11425,10496,929,93
01-01-2021,Pathanamthitta,10614,9408,1206,182
01-01-2021,Alappuzha,7007,5983,1024,125
01-01-2021,Kottayam,12496,11134,1362,221
01-01-2021,Idukki,7773,7455,318,43
01-01-2021,Ernakulam,29060,27816,1244,113
01-01-2021,Thrissur,22331,21153,1178,122
01-01-2021,Palakkad,9213,8652,561,41
01-01-2021,Malappuram,66531,65640,891,91
01-01-2021,Kozhikode,20899,19928,971,117
01-01-2021,Wayanad,9091,8614,477,40
01-01-2021,Kannur,12393,11949,444,58
01-01-2021,Kasaragod,4152,3931,221,16
01-01-2021,total,243828,231831,11997,1384
02-01-2021,Thiruvananthapuram,20282,19116,1166,113
02-01-2021,Kollam,9953,9114,839,92
02-01-2021,Pathanamthitta,10620,9425,1195,145
02-01-2021,Alappuzha,6957,5939,1018,144
02-01-2021,Kottayam,12846,11521,1325,149
02-01-2021,Idukki,7713,7407,306,25
02-01-2021,Ernakulam,28886,27637,1249,83
02-01-2021,Thrissur,22816,21682,1134,143
02-01-2021,Palakkad,9632,9056,576,72
02-01-2021,Malappuram,65465,64494,971,95
02-01-2021,Kozhikode,20579,19658,921,70
02-01-2021,Wayanad,8633,8221,412,39
02-01-2021,Kannur,12131,11646,485,48
02-01-2021,Kasaragod,3977,3763,214,5
02-01-2021,total,240490,228679,11811,1223
05-01-2021,Thiruvananthapuram,19721,18575,1146,135
05-01-2021,Kollam,9595,8889,706,74
05-01-2021,Pathanamthitta,10640,9580,1060,64
05-01-2021,Alappuzha,6826,5812,1014,77
05-01-2021,Kottayam,11808,10567,1241,99
05-01-2021,Idukki,7042,6647,395,25
05-01-2021,Ernakulam,26480,25125,1355,146
05-01-2021,Thrissur,23531,22445,1086,96
05-01-2021,Palakkad,9135,8613,522,66
05-01-2021,Malappuram,20976,20234,742,92
05-01-2021,Kozhikode,20264,19365,899,116
05-01-2021,Wayanad,8613,8264,349,49
05-01-2021,Kannur,12435,12007,428,43
05-01-2021,Kasaragod,3924,3745,179,0
05-01-2021,total,190990,179868,11122,1082
06-01-2021,Thiruvananthapuram,19759,18578,1181,149
06-01-2021,Kollam,9513,8812,701,105
06-01-2021,Pathanamthitta,10655,9509,1146,86
06-01-2021,Alappuzha,7089,6021,1068,123
06-01-2021,Kottayam,11724,10518,1206,247
06-01-2021,Idukki,7086,6664,422,35
06-01-2021,Ernakulam,26704,25393,1311,158
06-01-2021,Thrissur,24102,23064,1038,120
06-01-2021,Palakkad,9077,8587,490,55
06-01-2021,Malappuram,21136,20428,708,66
06-01-2021,Kozhikode,20395,19513,882,84
06-01-2021,Wayanad,8356,7988,368,53
06-01-2021,Kannur,12591,12168,423,51
06-01-2021,Kasaragod,3898,3704,194,20
06-01-2021,total,192085,180947,11138,1352
07-01-2021,Thiruvananthapuram,20465,19259,1206,125
07-01-2021,Kollam,9506,8802,704,83
07-01-2021,Pathanamthitta,10650,9406,1244,150
07-01-2021,Alappuzha,7359,6250,1109,144
07-01-2021,Kottayam,11589,10309,1280,206
07-01-2021,Idukki,6064,5642,422,27
07-01-2021,Ernakulam,26938,25550,1388,187
07-01-2021,Thrissur,24553,23489,1064,155
07-01-2021,Palakkad,9047,8551,496,49
07-01-2021,Malappuram,21337,20669,668,60
07-01-2021,Kozhikode,20409,19533,876,90
07-01-2021,Wayanad,8603,8234,369,47
07-01-2021,Kannur,12749,12338,411,38
07-01-2021,Kasaragod,4101,3903,198,18
07-01-2021,total,193370,181935,11435,1379
08-01-2021,Thiruvananthapuram,20834,19660,1174,133
08-01-2021,Kollam,10106,9450,656,93
08-01-2021,Pathanamthitta,10669,9507,1162,154
08-01-2021,Alappuzha,7441,6312,1129,110
08-01-2021,Kottayam,12347,11150,1197,159
08-01-2021,Idukki,6445,6018,427,44
08-01-2021,Ernakulam,27386,26022,1364,125
08-01-2021,Thrissur,24920,23868,1052,122
08-01-2021,Palakkad,9215,8721,494,53
08-01-2021,Malappuram,21847,21200,647,79
08-01-2021,Kozhikode,21136,20217,919,116
08-01-2021,Wayanad,8485,8127,358,39
08-01-2021,Kannur,13117,12722,395,51
08-01-2021,Kasaragod,4322,4130,192,23
08-01-2021,total,198270,187104,11166,1301
10-01-2021,Thiruvananthapuram,21083,19944,1139,118
10-01-2021,Kollam,10387,9757,630,88
10-01-2021,Pathanamthitta,10740,9657,1083,110
10-01-2021,Alappuzha,8085,6944,1141,124
10-01-2021,Kottayam,13305,12107,1198,191
10-01-2021,Idukki,7044,6601,443,37
10-01-2021,Ernakulam,27010,25641,1369,105
10-01-2021,Thrissur,25608,24584,1024,98
10-01-2021,Palakkad,9766,9297,469,22
10-01-2021,Malappuram,21923,21288,635,75
10-01-2021,Kozhikode,21266,20396,870,75
10-01-2021,Wayanad,8931,8579,352,45
10-01-2021,Kannur,13952,13569,383,51
10-01-2021,Kasaragod,4835,4617,218,16
10-01-2021,total,203935,192981,10954,1155
12-01-2021,Thiruvananthapuram,20786,19610,1176,148
12-01-2021,Kollam,10735,10133,602,84
12-01-2021,Pathanamthitta,10801,9752,1049,121
12-01-2021,Alappuzha,8527,7518,1009,70
12-01-2021,Kottayam,12790,11741,1049,130
12-01-2021,Idukki,7248,6793,455,38
12-01-2021,Ernakulam,22642,21291,1351,158
12-01-2021,Thrissur,24975,24016,959,78
12-01-2021,Palakkad,9717,9271,446,37
12-01-2021,Malappuram,21752,21096,656,105
12-01-2021,Kozhikode,21118,20240,878,79
12-01-2021,Wayanad,8930,8581,349,39
12-01-2021,Kannur,13987,13630,357,37
12-01-2021,Kasaragod,5511,5301,210,6
12-01-2021,total,199519,188973,10546,1130
13-01-2021,Thiruvananthapuram,20865,19658,1207,133
13-01-2021,Kollam,11213,10566,647,105
13-01-2021,Pathanamthitta,10837,9816,1021,81
13-01-2021,Alappuzha,8825,7859,966,83
13-01-2021,Kottayam,13147,12029,1118,248
13-01-2021,Idukki,7141,6683,458,28
13-01-2021,Ernakulam,23195,21829,1366,172
13-01-2021,Thrissur,24743,23800,943,107
13-01-2021,Palakkad,9481,9020,461,53
13-01-2021,Malappuram,21524,20857,667,115
13-01-2021,Kozhikode,20943,20035,908,95
13-01-2021,Wayanad,8809,8453,356,50
13-01-2021,Kannur,13802,13423,379,55
13-01-2021,Kasaragod,5734,5522,212,8
13-01-2021,total,200259,189550,10709,1333
14-01-2021,Thiruvananthapuram,21207,20017,1190,136
14-01-2021,Kollam,11001,10333,668,96
14-01-2021,Pathanamthitta,10887,9835,1052,98
14-01-2021,Alappuzha,9083,8092,991,112
14-01-2021,Kottayam,13625,12363,1262,217
14-01-2021,Idukki,7414,6924,490,48
14-01-2021,Ernakulam,23483,22115,1368,145
14-01-2021,Thrissur,24513,23552,961,109
14-01-2021,Palakkad,9499,9033,466,45
14-01-2021,Malappuram,21294,20687,607,607
14-01-2021,Kozhikode,21248,20314,934,103
14-01-2021,Wayanad,8775,8419,356,45
14-01-2021,Kannur,13244,12881,363,44
14-01-2021,Kasaragod,6020,5824,196,16
14-01-2021,total,201293,190389,10904,1821
15-01-2021,Thiruvananthapuram,21583,20381,1202,157
15-01-2021,Kollam,11207,10547,660,79
15-01-2021,Pathanamthitta,10956,9892,1064,128
15-01-2021,Alappuzha,9192,8204,988,124
15-01-2021,Kottayam,13509,12215,1294,178
15-01-2021,Idukki,7554,7054,500,49
15-01-2021,Ernakulam,23902,22525,1377,124
15-01-2021,Thrissur,24332,23376,956,127
15-01-2021,Palakkad,9418,8962,456,46
15-01-2021,Malappuram,20860,20190,670,70
15-01-2021,Kozhikode,21633,20649,984,111
15-01-2021,Wayanad,8866,8509,357,49
15-01-2021,Kannur,13046,12673,373,49
15-01-2021,Kasaragod,6022,5822,200,17
15-01-2021,total,202080,190999,11081,1308
16-01-2021,Thiruvananthapuram,21801,20578,1223,188
16-01-2021,Kollam,11369,10691,678,101
16-01-2021,Pathanamthitta,11533,10460,1073,124
16-01-2021,Alappuzha,9181,8166,1015,119
16-01-2021,Kottayam,14161,12876,1285,197
16-01-2021,Idukki,7643,7152,491,38
16-01-2021,Ernakulam,24139,22754,1385,143
16-01-2021,Thrissur,24337,23398,939,127
16-01-2021,Palakkad,9506,9068,438,39
16-01-2021,Malappuram,20777,20130,647,65
16-01-2021,Kozhikode,21829,20855,974,82
16-01-2021,Wayanad,8881,8532,349,43
16-01-2021,Kannur,14025,13651,374,56
16-01-2021,Kasaragod,6379,6156,223,33
16-01-2021,total,205561,194467,11094,1355
17-01-2021,Thiruvananthapuram,22109,20894,1215,116
17-01-2021,Kollam,11515,10836,679,80
17-01-2021,Pathanamthitta,12347,11223,1124,148
17-01-2021,Alappuzha,9662,8603,1059,132
17-01-2021,Kottayam,14532,13246,1286,179
17-01-2021,Idukki,7709,7228,481,19
17-01-2021,Ernakulam,24929,23520,1409,124
17-01-2021,Thrissur,23949,23009,940,108
17-01-2021,Palakkad,9544,9117,427,44
17-01-2021,Malappuram,20902,20287,615,50
17-01-2021,Kozhikode,22397,21450,947,90
17-01-2021,Wayanad,8907,8565,342,40
17-01-2021,Kannur,14736,14329,407,54
17-01-2021,Kasaragod,6441,6195,246,33
17-01-2021,total,209679,198502,11177,1217
18-01-2021,Thiruvananthapuram,22044,20832,1212,153
18-01-2021,Kollam,11666,10975,691,90
18-01-2021,Pathanamthitta,13340,12268,1072,108
18-01-2021,Alappuzha,9635,8651,984,112
18-01-2021,Kottayam,14096,12788,1308,143
18-01-2021,Idukki,7812,7305,507,50
18-01-2021,Ernakulam,25094,23688,1406,112
18-01-2021,Thrissur,23500,22589,911,89
18-01-2021,Palakkad,9703,9263,440,48
18-01-2021,Malappuram,20796,20193,603,60
18-01-2021,Kozhikode,22184,21221,963,77
18-01-2021,Wayanad,8861,8528,333,128
18-01-2021,Kannur,14439,14027,412,59
18-01-2021,Kasaragod,6616,6353,263,18
18-01-2021,total,209786,198681,11105,1247
20-01-2021,Thiruvananthapuram,21530,20306,1224,129
20-01-2021,Kollam,11902,11125,777,110
20-01-2021,Pathanamthitta,13826,12743,1083,96
20-01-2021,Alappuzha,10164,9167,997,119
20-01-2021,Kottayam,15145,13787,1358,260
20-01-2021,Idukki,7968,7460,508,32
20-01-2021,Ernakulam,25646,24178,1468,191
20-01-2021,Thrissur,22941,22035,906,126
20-01-2021,Palakkad,9321,8874,447,52
20-01-2021,Malappuram,20387,19739,648,120
20-01-2021,Kozhikode,21797,20829,968,77
20-01-2021,Wayanad,8707,8324,383,70
20-01-2021,Kannur,13169,12730,439,58
20-01-2021,Kasaragod,6615,6359,256,20
20-01-2021,total,209118,197656,11462,1460
21-01-2021,Thiruvananthapuram,21832,20573,1259,172
21-01-2021,Kollam,11977,11182,795,101
21-01-2021,Pathanamthitta,13883,12750,1133,113
21-01-2021,Alappuzha,10316,9254,1062,140
21-01-2021,Kottayam,15459,14113,1346,224
21-01-2021,Idukki,8220,7708,512,61
21-01-2021,Ernakulam,26837,25350,1487,155
21-01-2021,Thrissur,22841,21906,935,118
21-01-2021,Palakkad,9189,8736,453,42
21-01-2021,Malappuram,20229,19571,658,130
21-01-2021,Kozhikode,21573,20609,964,103
21-01-2021,Wayanad,7919,7528,391,46
21-01-2021,Kannur,13153,12685,468,66
21-01-2021,Kasaragod,6400,6142,258,11
21-01-2021,total,209828,198107,11721,1482
22-01-2021,Thiruvananthapuram,22346,21080,1266,147
22-01-2021,Kollam,12105,11240,865,197
22-01-2021,Pathanamthitta,13967,12874,1093,132
22-01-2021,Alappuzha,11116,10025,1091,99
22-01-2021,Kottayam,15599,14257,1342,223
22-01-2021,Idukki,8397,7867,530,60
22-01-2021,Ernakulam,26473,24965,1508,152
22-01-2021,Thrissur,22487,21564,923,99
22-01-2021,Palakkad,9213,8753,460,55
22-01-2021,Malappuram,20263,19594,669,135
22-01-2021,Kozhikode,21831,20840,991,124
22-01-2021,Wayanad,7451,7059,392,43
22-01-2021,Kannur,13694,13207,487,59
22-01-2021,Kasaragod,6335,6079,256,19
22-01-2021,total,211277,199404,11873,1544
23-01-2021,Thiruvananthapuram,22507,21169,1338,196
23-01-2021,Kollam,12441,11572,869,103
23-01-2021,Pathanamthitta,14024,12887,1137,110
23-01-2021,Alappuzha,11811,10732,1079,97
23-01-2021,Kottayam,15589,14213,1376,193
23-01-2021,Idukki,8651,8163,488,39
23-01-2021,Ernakulam,25993,24492,1501,156
23-01-2021,Thrissur,22266,21324,942,26
23-01-2021,Palakkad,9339,8872,467,62
23-01-2021,Malappuram,20444,19849,595,60
23-01-2021,Kozhikode,21749,20739,1010,115
23-01-2021,Wayanad,7165,6758,407,49
23-01-2021,Kannur,13418,12925,493,66
23-01-2021,Kasaragod,6427,6194,233,10
23-01-2021,total,211824,199889,11935,1282
24-01-2021,Thiruvananthapuram,23116,21766,1350,144
24-01-2021,Kollam,12670,11783,887,98
24-01-2021,Pathanamthitta,14139,12974,1165,145
24-01-2021,Alappuzha,11936,10779,1157,148
24-01-2021,Kottayam,16013,14617,1396,165
24-01-2021,Idukki,8909,8405,504,41
24-01-2021,Ernakulam,26780,25224,1556,159
24-01-2021,Thrissur,22221,21283,938,127
24-01-2021,Palakkad,9402,8910,492,69
24-01-2021,Malappuram,20613,19994,619,124
24-01-2021,Kozhikode,22094,21082,1012,104
24-01-2021,Wayanad,7136,6718,418,57
24-01-2021,Kannur,12950,12447,503,56
24-01-2021,Kasaragod,6310,6081,229,16
24-01-2021,total,214289,202063,12226,1453
26-01-2021,Thiruvananthapuram,23227,21928,1299,169
26-01-2021,Kollam,11613,10713,900,101
26-01-2021,Pathanamthitta,14329,13265,1064,110
26-01-2021,Alappuzha,12075,10961,1114,82
26-01-2021,Kottayam,15769,14404,1365,108
26-01-2021,Idukki,9225,8711,514,54
26-01-2021,Ernakulam,28238,26656,1582,221
26-01-2021,Thrissur,21855,20960,895,106
26-01-2021,Palakkad,9369,8876,493,44
26-01-2021,Malappuram,20599,20041,558,57
26-01-2021,Kozhikode,22045,21055,990,87
26-01-2021,Wayanad,7205,6775,430,76
26-01-2021,Kannur,12982,12470,512,62
26-01-2021,Kasaragod,6025,5794,231,8
26-01-2021,total,214556,202609,11947,1285
28-01-2021,Thiruvananthapuram,23151,21821,1330,198
28-01-2021,Kollam,11997,11132,865,98
28-01-2021,Pathanamthitta,14335,13381,954,106
28-01-2021,Alappuzha,12645,11507,1138,114
28-01-2021,Kottayam,16603,15228,1375,424
28-01-2021,Idukki,9512,8983,529,47
28-01-2021,Ernakulam,27499,25997,1502,150
28-01-2021,Thrissur,21816,20896,920,119
28-01-2021,Palakkad,9242,8721,521,51
28-01-2021,Malappuram,20666,20142,524,66
28-01-2021,Kozhikode,21599,20636,963,115
28-01-2021,Wayanad,7097,6667,430,35
28-01-2021,Kannur,12922,12406,516,65
28-01-2021,Kasaragod,5851,5609,242,13
28-01-2021,total,214935,203126,11809,1601
29-01-2021,Thiruvananthapuram,23515,22182,1333,156
29-01-2021,Kollam,11944,11080,864,106
29-01-2021,Pathanamthitta,14314,13346,968,94
29-01-2021,Alappuzha,12653,11480,1173,128
29-01-2021,Kottayam,16247,14916,1331,365
29-01-2021,Idukki,9792,9278,514,34
29-01-2021,Ernakulam,27198,25707,1491,118
29-01-2021,Thrissur,22109,21167,942,119
29-01-2021,Palakkad,9350,8815,535,63
29-01-2021,Malappuram,20705,20207,498,74
29-01-2021,Kozhikode,21744,20807,937,101
29-01-2021,Wayanad,7219,6824,395,42
29-01-2021,Kannur,12955,12435,520,77
29-01-2021,Kasaragod,5905,5654,251,19
29-01-2021,total,215650,203898,11752,1496
31-01-2021,Thiruvananthapuram,23870,22545,1325,117
31-01-2021,Kollam,11889,11075,814,87
31-01-2021,Pathanamthitta,14235,13347,888,90
31-01-2021,Alappuzha,12999,11778,1221,145
31-01-2021,Kottayam,17289,16092,1197,263
31-01-2021,Idukki,10004,9537,467,11
31-01-2021,Ernakulam,27292,25830,1462,135
31-01-2021,Thrissur,22604,21645,959,100
31-01-2021,Palakkad,9553,9004,549,63
31-01-2021,Malappuram,20875,20400,475,116
31-01-2021,Kozhikode,22134,21212,922,98
31-01-2021,Wayanad,7258,6899,359,33
31-01-2021,Kannur,12731,12170,561,53
31-01-2021,Kasaragod,6141,5858,283,19
31-01-2021,total,218874,207392,11482,1330
01-02-2021,Thiruvananthapuram,23734,22456,1278,92
01-02-2021,Kollam,11327,10541,786,56
01-02-2021,Pathanamthitta,14183,13326,857,92
01-02-2021,Alappuzha,12686,11532,1154,96
01-02-2021,Kottayam,18154,17030,1124,306
01-02-2021,Idukki,10040,9533,507,52
01-02-2021,Ernakulam,26738,25282,1456,143
01-02-2021,Thrissur,22931,21981,950,105
01-02-2021,Palakkad,9716,9172,544,42
01-02-2021,Malappuram,20934,20469,465,90
01-02-2021,Kozhikode,22112,21245,867,62
01-02-2021,Wayanad,7108,6767,341,18
01-02-2021,Kannur,13183,12651,532,36
01-02-2021,Kasaragod,6063,5806,257,15
01-02-2021,total,218909,207791,11118,1205
02-02-2021,Thiruvananthapuram,23739,22500,1239,149
02-02-2021,Kollam,11095,10312,783,91
02-02-2021,Pathanamthitta,14219,13425,794,102
02-02-2021,Alappuzha,12511,11367,1144,99
02-02-2021,Kottayam,17936,16766,1170,151
02-02-2021,Idukki,10058,9532,526,55
02-02-2021,Ernakulam,26960,25533,1427,99
02-02-2021,Thrissur,22370,21442,928,98
02-02-2021,Palakkad,9803,9277,526,64
02-02-2021,Malappuram,21070,20608,462,97
02-02-2021,Kozhikode,22371,21523,848,78
02-02-2021,Wayanad,7138,6823,315,25
02-02-2021,Kannur,13090,12567,523,38
02-02-2021,Kasaragod,5987,5733,254,3
02-02-2021,total,218347,207408,10939,1149
04-02-2021,Thiruvananthapuram,24484,23173,1311,158
04-02-2021,Kollam,11190,10444,746,114
04-02-2021,Pathanamthitta,14863,14022,841,123
04-02-2021,Alappuzha,11807,10703,1104,110
04-02-2021,Kottayam,16128,14952,1176,337
04-02-2021,Idukki,10210,9720,490,28
04-02-2021,Ernakulam,26071,24708,1363,96
04-02-2021,Thrissur,21073,20128,945,99
04-02-2021,Palakkad,9745,9296,449,58
04-02-2021,Malappuram,20998,20512,486,122
04-02-2021,Kozhikode,21835,20976,859,95
04-02-2021,Wayanad,6907,6610,297,29
04-02-2021,Kannur,13428,12874,554,66
04-02-2021,Kasaragod,6241,6006,235,32
04-02-2021,total,214980,204124,10856,1467
05-02-2021,Thiruvananthapuram,24521,23232,1289,139
05-02-2021,Kollam,11317,10578,739,95
05-02-2021,Pathanamthitta,15717,14806,911,155
05-02-2021,Alappuzha,11438,10320,1118,122
05-02-2021,Kottayam,16511,15352,1159,233
05-02-2021,Idukki,10057,9568,489,50
05-02-2021,Ernakulam,25816,24465,1351,163
05-02-2021,Thrissur,20659,19710,949,126
05-02-2021,Palakkad,9815,9236,579,130
05-02-2021,Malappuram,20964,20489,475,89
05-02-2021,Kozhikode,22026,21190,836,98
05-02-2021,Wayanad,7007,6742,265,31
05-02-2021,Kannur,13385,12835,550,86
05-02-2021,Kasaragod,6420,6170,250,23
05-02-2021,total,215653,204693,10960,1540
06-02-2021,Thiruvananthapuram,25563,24267,1296,165
06-02-2021,Kollam,11582,10849,733,87
06-02-2021,Pathanamthitta,16632,15657,975,137
06-02-2021,Alappuzha,11934,10849,1085,125
06-02-2021,Kottayam,15781,14652,1129,218
06-02-2021,Idukki,9853,9375,478,38
06-02-2021,Ernakulam,25778,24380,1398,147
06-02-2021,Thrissur,20893,19983,910,113
06-02-2021,Palakkad,9977,9397,580,49
06-02-2021,Malappuram,21529,21032,497,122
06-02-2021,Kozhikode,22530,21744,786,89
06-02-2021,Wayanad,6874,6599,275,44
06-02-2021,Kannur,13528,12984,544,48
06-02-2021,Kasaragod,6596,6345,251,13
06-02-2021,total,219050,208113,10937,1395
07-02-2021,Thiruvananthapuram,26707,25446,1261,106
07-02-2021,Kollam,11795,11036,759,81
07-02-2021,Pathanamthitta,17499,16513,986,111
07-02-2021,Alappuzha,12205,11097,1108,119
07-02-2021,Kottayam,16087,14934,1153,276
07-02-2021,Idukki,9737,9287,450,20
07-02-2021,Ernakulam,25630,24250,1380,128
07-02-2021,Thrissur,21540,20631,909,85
07-02-2021,Palakkad,10046,9494,552,45
07-02-2021,Malappuram,22799,22295,504,107
07-02-2021,Kozhikode,23670,22908,762,95
07-02-2021,Wayanad,6270,5999,271,33
07-02-2021,Kannur,13764,13224,540,49
07-02-2021,Kasaragod,6910,6660,250,15
07-02-2021,total,224659,213774,10885,1270
08-02-2021,Thiruvananthapuram,26732,25510,1222,114
08-02-2021,Kollam,12692,11914,778,116
08-02-2021,Pathanamthitta,18210,17194,1016,123
08-02-2021,Alappuzha,11755,10771,984,54
08-02-2021,Kottayam,15563,14459,1104,327
08-02-2021,Idukki,9678,9204,474,51
08-02-2021,Ernakulam,24710,23350,1360,75
08-02-2021,Thrissur,22096,21193,903,103
08-02-2021,Palakkad,10231,9690,541,41
08-02-2021,Malappuram,22912,22436,476,72
08-02-2021,Kozhikode,23448,22682,766,90
08-02-2021,Wayanad,6158,5885,273,36
08-02-2021,Kannur,13662,13136,526,45
08-02-2021,Kasaragod,6912,6671,241,17
08-02-2021,total,224759,214095,10664,1264
09-02-2021,Thiruvananthapuram,28005,26770,1235,163
09-02-2021,Kollam,14060,13369,691,97
09-02-2021,Pathanamthitta,18447,17473,974,91
09-02-2021,Alappuzha,12253,11272,981,98
09-02-2021,Kottayam,15968,14930,1038,173
09-02-2021,Idukki,9721,9274,447,50
09-02-2021,Ernakulam,25245,23935,1310,87
09-02-2021,Thrissur,22626,21739,887,134
09-02-2021,Palakkad,10739,10218,521,57
09-02-2021,Malappuram,23878,23395,483,107
09-02-2021,Kozhikode,25442,24726,716,56
09-02-2021,Wayanad,6017,5765,252,24
09-02-2021,Kannur,14329,13856,473,32
09-02-2021,Kasaragod,6934,6712,222,10
09-02-2021,total,233664,223434,10230,1179
10-02-2021,Thiruvananthapuram,28257,27007,1250,134
10-02-2021,Kollam,14670,13884,786,98
10-02-2021,Pathanamthitta,18830,17854,976,81
10-02-2021,Alappuzha,11780,10801,979,95
10-02-2021,Kottayam,16633,15532,1101,141
10-02-2021,Idukki,9753,9320,433,33
10-02-2021,Ernakulam,25079,23751,1328,147
10-02-2021,Thrissur,22001,21114,887,107
10-02-2021,Palakkad,10869,10362,507,44
10-02-2021,Malappuram,23874,23376,498,115
10-02-2021,Kozhikode,25439,24729,710,99
10-02-2021,Wayanad,6174,5923,251,20
10-02-2021,Kannur,14504,14055,449,39
10-02-2021,Kasaragod,6904,6670,234,25
10-02-2021,total,234767,224378,10389,1178
11-02-2021,Thiruvananthapuram,28521,27266,1255,151
11-02-2021,Kollam,15257,14500,757,95
11-02-2021,Pathanamthitta,20173,19178,995,120
11-02-2021,Alappuzha,11770,10868,902,62
11-02-2021,Kottayam,15795,14633,1162,198
11-02-2021,Idukki,9932,9501,431,33
11-02-2021,Ernakulam,24264,22924,1340,86
11-02-2021,Thrissur,22487,21577,910,110
11-02-2021,Palakkad,11039,10532,507,46
11-02-2021,Malappuram,23979,23499,480,82
11-02-2021,Kozhikode,25172,24424,748,81
11-02-2021,Wayanad,6345,6101,244,20
11-02-2021,Kannur,14264,13858,406,26
11-02-2021,Kasaragod,7187,6942,245,18
11-02-2021,total,236185,225803,10382,1128
12-02-2021,Thiruvananthapuram,28747,27507,1240,125
12-02-2021,Kollam,15839,15077,762,110
12-02-2021,Pathanamthitta,21558,20543,1015,155
12-02-2021,Alappuzha,11980,11004,976,158
12-02-2021,Kottayam,16339,15211,1128,127
12-02-2021,Idukki,9549,9111,438,48
12-02-2021,Ernakulam,24580,23298,1282,92
12-02-2021,Thrissur,23250,22322,928,131
12-02-2021,Palakkad,11157,10663,494,41
12-02-2021,Malappuram,24240,23747,493,113
12-02-2021,Kozhikode,26022,25265,757,92
12-02-2021,Wayanad,6440,6193,247,28
12-02-2021,Kannur,14291,13904,387,44
12-02-2021,Kasaragod,7370,7097,273,30
12-02-2021,total,241362,230942,10420,1294
13-02-2021,Thiruvananthapuram,28982,27756,1226,118
13-02-2021,Kollam,15490,14718,772,101
13-02-2021,Pathanamthitta,23116,22141,975,146
13-02-2021,Alappuzha,12361,11447,914,46
13-02-2021,Kottayam,16299,15212,1087,120
13-02-2021,Idukki,9777,9330,447,47
13-02-2021,Ernakulam,25131,23905,1226,120
13-02-2021,Thrissur,22954,22026,928,109
13-02-2021,Palakkad,11196,10725,471,36
13-02-2021,Malappuram,24514,24028,486,93
13-02-2021,Kozhikode,26675,25959,716,95
13-02-2021,Wayanad,6483,6240,243,27
13-02-2021,Kannur,14076,13708,368,42
13-02-2021,Kasaragod,7031,6756,275,18
13-02-2021,total,244085,233951,10134,1118
14-02-2021,Thiruvananthapuram,29404,28191,1213,146
14-02-2021,Kollam,16561,15778,783,88
14-02-2021,Pathanamthitta,24448,23484,964,109
14-02-2021,Alappuzha,12687,11693,994,179
14-02-2021,Kottayam,16268,15187,1081,172
14-02-2021,Idukki,9581,9185,396,44
14-02-2021,Ernakulam,26448,25216,1232,85
14-02-2021,Thrissur,22901,21965,936,105
14-02-2021,Palakkad,11192,10737,455,54
14-02-2021,Malappuram,24520,24053,467,81
14-02-2021,Kozhikode,26728,26015,713,76
14-02-2021,Wayanad,6468,6222,246,36
14-02-2021,Kannur,14011,13661,350,32
14-02-2021,Kasaragod,7452,7158,294,30
14-02-2021,total,248669,238545,10124,1237
15-02-2021,Thiruvananthapuram,29258,28062,1196,100
15-02-2021,Kollam,16712,15971,741,75
15-02-2021,Pathanamthitta,24229,23256,973,128
15-02-2021,Alappuzha,14017,13100,917,60
15-02-2021,Kottayam,16290,15235,1055,153
15-02-2021,Idukki,9387,9048,339,28
15-02-2021,Ernakulam,27877,26682,1195,40
15-02-2021,Thrissur,23003,22084,919,81
15-02-2021,Palakkad,11207,10681,526,116
15-02-2021,Malappuram,24750,24295,455,80
15-02-2021,Kozhikode,26378,25658,720,45
15-02-2021,Wayanad,6403,6167,236,21
15-02-2021,Kannur,13780,13473,307,20
15-02-2021,Kasaragod,7433,7147,286,15
15-02-2021,total,250724,240859,9865,962
16-02-2021,Thiruvananthapuram,28994,27867,1127,109
16-02-2021,Kollam,17009,16317,692,77
16-02-2021,Pathanamthitta,24019,23075,944,114
16-02-2021,Alappuzha,14570,13611,959,99
16-02-2021,Kottayam,16824,15790,1034,173
16-02-2021,Idukki,8410,8087,323,38
16-02-2021,Ernakulam,30412,29265,1147,75
16-02-2021,Thrissur,23124,22262,862,75
16-02-2021,Palakkad,11213,10793,420,38
16-02-2021,Malappuram,24833,24356,477,122
16-02-2021,Kozhikode,26232,25504,728,67
16-02-2021,Wayanad,6405,6183,222,28
16-02-2021,Kannur,14094,13794,300,48
16-02-2021,Kasaragod,7456,7181,275,8
16-02-2021,total,253595,244085,9510,1071
17-02-2021,Thiruvananthapuram,28925,27774,1151,196
17-02-2021,Kollam,17669,16996,673,94
17-02-2021,Pathanamthitta,23587,22644,943,25
17-02-2021,Alappuzha,15246,14299,947,28
17-02-2021,Kottayam,18997,17937,1060,48
17-02-2021,Idukki,7860,7516,344,30
17-02-2021,Ernakulam,31574,30450,1124,198
17-02-2021,Thrissur,23310,22446,864,83
17-02-2021,Palakkad,11080,10690,390,61
17-02-2021,Malappuram,24864,24414,450,73
17-02-2021,Kozhikode,26180,25515,665,92
17-02-2021,Wayanad,6419,6186,233,20
17-02-2021,Kannur,14180,13869,311,47
17-02-2021,Kasaragod,7524,7248,276,7
17-02-2021,total,257415,247984,9431,1002
18-02-2021,Thiruvananthapuram,28846,27696,1150,107
18-02-2021,Kollam,17916,17251,665,76
18-02-2021,Pathanamthitta,23803,22763,1040,131
18-02-2021,Alappuzha,15024,14099,925,117
18-02-2021,Kottayam,18750,17678,1072,171
18-02-2021,Idukki,7305,6954,351,34
18-02-2021,Ernakulam,30504,29404,1100,112
18-02-2021,Thrissur,23365,22495,870,119
18-02-2021,Palakkad,10899,10504,395,34
18-02-2021,Malappuram,24924,24486,438,88
18-02-2021,Kozhikode,26377,25694,683,64
18-02-2021,Wayanad,6384,6153,231,31
18-02-2021,Kannur,14249,13943,306,32
18-02-2021,Kasaragod,7511,7231,280,15
18-02-2021,total,255857,246351,9506,1131
19-02-2021,Thiruvananthapuram,28232,27085,1147,135
19-02-2021,Kollam,18116,17463,653,90
19-02-2021,Pathanamthitta,23764,22849,915,117
19-02-2021,Alappuzha,14842,13941,901,84
19-02-2021,Kottayam,20777,19720,1057,128
19-02-2021,Idukki,6371,6039,332,33
19-02-2021,Ernakulam,29786,28735,1051,67
19-02-2021,Thrissur,23023,22182,841,95
19-02-2021,Palakkad,10753,10362,391,57
19-02-2021,Malappuram,24849,24419,430,92
19-02-2021,Kozhikode,26332,25665,667,91
19-02-2021,Wayanad,6305,6094,211,18
19-02-2021,Kannur,13980,13667,313,45
19-02-2021,Kasaragod,7390,7108,282,41
19-02-2021,total,254520,245329,9191,1093
20-02-2021,Thiruvananthapuram,28099,27002,1097,100
20-02-2021,Kollam,18728,18079,649,95
20-02-2021,Pathanamthitta,23593,22683,910,110
20-02-2021,Alappuzha,15361,14505,856,55
20-02-2021,Kottayam,16864,15824,1040,132
20-02-2021,Idukki,4851,4516,335,28
20-02-2021,Ernakulam,28871,27822,1049,95
20-02-2021,Thrissur,23183,22352,831,86
20-02-2021,Palakkad,10815,10432,383,38
20-02-2021,Malappuram,24693,24299,394,64
20-02-2021,Kozhikode,26025,25378,647,78
20-02-2021,Wayanad,5940,5724,216,24
20-02-2021,Kannur,13596,13297,299,34
20-02-2021,Kasaragod,7161,6878,283,10
20-02-2021,total,247780,238791,8989,949
21-02-2021,Thiruvananthapuram,,26856,1064,98
21-02-2021,Kollam,17721,17083,638,56
21-02-2021,Pathanamthitta,23449,22577,872,111
21-02-2021,Alappuzha,16305,15416,889,127
21-02-2021,Kottayam,17364,16070,1294,78
21-02-2021,Idukki,4996,4683,313,22
21-02-2021,Ernakulam,28447,27399,1048,69
21-02-2021,Thrissur,23482,22627,855,133
21-02-2021,Palakkad,10772,10414,358,33
21-02-2021,Malappuram,25006,24615,391,97
21-02-2021,Kozhikode,26007,25393,614,64
21-02-2021,Wayanad,5997,5787,210,23
21-02-2021,Kannur,12536,12225,311,34
21-02-2021,Kasaragod,6809,6515,294,21
21-02-2021,total,246811,237660,9151,966
22-02-2021,Thiruvananthapuram,26426,25436,990,69
22-02-2021,Kollam,16993,16413,580,67
22-02-2021,Pathanamthitta,23381,22511,870,62
22-02-2021,Alappuzha,16347,15552,795,88
22-02-2021,Kottayam,17783,16814,969,156
22-02-2021,Idukki,4916,4649,267,21
22-02-2021,Ernakulam,28604,27589,1015,48
22-02-2021,Thrissur,23572,22748,824,89
22-02-2021,Palakkad,10264,9930,334,15
22-02-2021,Malappuram,24633,24251,382,91
22-02-2021,Kozhikode,24737,24112,625,54
22-02-2021,Wayanad,5923,5732,191,12
22-02-2021,Kannur,11919,11612,307,30
22-02-2021,Kasaragod,6572,6275,297,23
22-02-2021,total,242070,233624,8446,825
24-02-2021,Thiruvananthapuram,25251,24273,978,116
24-02-2021,Kollam,15561,15009,552,71
24-02-2021,Pathanamthitta,21710,21002,708,44
24-02-2021,Alappuzha,16049,15302,747,77
24-02-2021,Kottayam,18007,17086,921,150
24-02-2021,Idukki,4095,3835,260,31
24-02-2021,Ernakulam,26194,25249,945,83
24-02-2021,Thrissur,23342,22602,740,86
24-02-2021,Palakkad,9455,9113,342,22
24-02-2021,Malappuram,22783,22436,347,83
24-02-2021,Kozhikode,23310,22679,631,72
24-02-2021,Wayanad,5675,5480,195,13
24-02-2021,Kannur,10455,10134,321,42
24-02-2021,Kasaragod,6529,6210,319,16
24-02-2021,total,228416,220410,8006,906
25-02-2021,Thiruvananthapuram,24691,23756,935,88
25-02-2021,Kollam,15395,14856,539,75
25-02-2021,Pathanamthitta,21784,21024,760,95
25-02-2021,Alappuzha,15523,14803,720,41
25-02-2021,Kottayam,17907,17035,872,127
25-02-2021,Idukki,3433,3176,257,25
25-02-2021,Ernakulam,26141,25207,934,65
25-02-2021,Thrissur,22691,21933,758,95
25-02-2021,Palakkad,8944,8600,344,37
25-02-2021,Malappuram,21637,21301,336,89
25-02-2021,Kozhikode,22659,22012,647,68
25-02-2021,Wayanad,5707,5519,188,31
25-02-2021,Kannur,10077,9751,326,49
25-02-2021,Kasaragod,6602,6272,330,20
25-02-2021,total,223191,215245,7946,905
26-02-2021,Thiruvananthapuram,24017,23103,914,100
26-02-2021,Kollam,15173,14650,523,61
26-02-2021,Pathanamthitta,21329,20648,681,97
26-02-2021,Alappuzha,15503,14746,757,110
26-02-2021,Kottayam,16766,15944,822,117
26-02-2021,Idukki,2950,2692,258,18
26-02-2021,Ernakulam,26106,25224,882,55
26-02-2021,Thrissur,22222,21488,734,80
26-02-2021,Palakkad,8649,8294,355,37
26-02-2021,Malappuram,21225,20894,331,95
26-02-2021,Kozhikode,21968,21379,589,68
26-02-2021,Wayanad,5662,5493,169,13
26-02-2021,Kannur,9791,9458,333,39
26-02-2021,Kasaragod,6598,6280,318,11
26-02-2021,total,217959,210293,7666,901
27-02-2021,Thiruvananthapuram,23531,22627,904,83
27-02-2021,Kollam,15064,14546,518,71
27-02-2021,Pathanamthitta,20935,20281,654,81
27-02-2021,Alappuzha,14776,14083,693,42
27-02-2021,Kottayam,15628,14825,803,69
27-02-2021,Idukki,2706,2472,234,32
27-02-2021,Ernakulam,25888,25031,857,58
27-02-2021,Thrissur,22395,21634,761,108
27-02-2021,Palakkad,8503,8152,351,25
27-02-2021,Malappuram,20656,20330,326,95
27-02-2021,Kozhikode,21527,20954,573,72
27-02-2021,Wayanad,5388,5225,163,19
27-02-2021,Kannur,9645,9315,330,36
27-02-2021,Kasaragod,6605,6290,315,20
27-02-2021,total,213247,205765,7482,811
28-02-2021,Thiruvananthapuram,23189,22312,877,66
28-02-2021,Kollam,15306,14782,524,60
28-02-2021,Pathanamthitta,20871,20246,625,63
28-02-2021,Alappuzha,14885,14188,697,79
28-02-2021,Kottayam,14210,13432,778,85
28-02-2021,Idukki,2706,2476,230,17
28-02-2021,Ernakulam,26257,25383,874,78
28-02-2021,Thrissur,22103,21361,742,88
28-02-2021,Palakkad,8412,8090,322,25
28-02-2021,Malappuram,20360,20048,312,86
28-02-2021,Kozhikode,21622,21057,565,78
28-02-2021,Wayanad,5172,5016,156,19
28-02-2021,Kannur,9589,9252,337,34
28-02-2021,Kasaragod,6362,6086,276,12
28-02-2021,total,211044,203729,7315,790
01-03-2021,Thiruvananthapuram,22321,21473,848,46
01-03-2021,Kollam,14734,14239,495,44
01-03-2021,Pathanamthitta,20815,20201,614,58
01-03-2021,Alappuzha,15155,14469,686,77
01-03-2021,Kottayam,14701,13899,802,136
01-03-2021,Idukki,2609,2366,243,24
01-03-2021,Ernakulam,25383,24524,859,54
01-03-2021,Thrissur,21722,21021,701,54
01-03-2021,Palakkad,7940,7639,301,15
01-03-2021,Malappuram,19987,19683,304,92
01-03-2021,Kozhikode,21411,20851,560,46
01-03-2021,Wayanad,5063,4923,140,9
01-03-2021,Kannur,9446,9097,349,38
01-03-2021,Kasaragod,6628,6371,257,18
01-03-2021,total,207915,200756,7159,711
02-03-2021,Thiruvananthapuram,21781,20975,806,91
02-03-2021,Kollam,13724,13210,514,72
02-03-2021,Pathanamthitta,20374,19839,535,47
02-03-2021,Alappuzha,15517,14862,655,37
02-03-2021,Kottayam,14719,14048,671,53
02-03-2021,Idukki,2667,2436,231,15
02-03-2021,Ernakulam,25029,24245,784,41
02-03-2021,Thrissur,21586,20611,975,59
02-03-2021,Palakkad,7821,7532,289,21
02-03-2021,Malappuram,19432,19143,289,85
02-03-2021,Kozhikode,21240,20716,524,54
02-03-2021,Wayanad,5001,4867,134,15
02-03-2021,Kannur,9597,9265,332,34
02-03-2021,Kasaragod,6827,6562,265,11
02-03-2021,total,205315,198311,7004,635
03-03-2021,Thiruvananthapuram,21092,20283,809,58
03-03-2021,Kollam,13474,12975,499,50
03-03-2021,Pathanamthitta,18609,18082,527,31
03-03-2021,Alappuzha,15086,14479,607,63
03-03-2021,Kottayam,14504,13857,647,75
03-03-2021,Idukki,2721,2498,223,11
03-03-2021,Ernakulam,24215,23445,770,52
03-03-2021,Thrissur,21147,20179,968,70
03-03-2021,Palakkad,7735,7438,297,31
03-03-2021,Malappuram,18883,18596,287,98
03-03-2021,Kozhikode,20520,19985,535,73
03-03-2021,Wayanad,4599,4463,136,14
03-03-2021,Kannur,9288,8930,358,41
03-03-2021,Kasaragod,6799,6529,270,16
03-03-2021,total,198672,191739,6933,683
05-03-2021,Thiruvananthapuram,19201,18461,740,97
05-03-2021,Kollam,13023,12589,434,44
05-03-2021,Pathanamthitta,10884,10407,477,47
05-03-2021,Alappuzha,13664,13088,576,41
05-03-2021,Kottayam,13000,12452,548,68
05-03-2021,Idukki,2945,2736,209,18
05-03-2021,Ernakulam,21465,20772,693,46
05-03-2021,Thrissur,20383,19434,949,82
05-03-2021,Palakkad,6465,6194,271,18
05-03-2021,Malappuram,18773,18509,264,68
05-03-2021,Kozhikode,19487,18980,507,50
05-03-2021,Wayanad,4542,4413,129,23
05-03-2021,Kannur,9456,9109,347,46
05-03-2021,Kasaragod,6819,6592,227,12
05-03-2021,total,180107,173736,6371,660
06-03-2021,Thiruvananthapuram,18552,17835,717,48
06-03-2021,Kollam,13090,12669,421,50
06-03-2021,Pathanamthitta,10737,10267,470,54
06-03-2021,Alappuzha,13270,12732,538,33
06-03-2021,Kottayam,12382,11879,503,55
06-03-2021,Idukki,2929,2748,181,19
06-03-2021,Ernakulam,20875,20197,678,57
06-03-2021,Thrissur,20053,19121,932,57
06-03-2021,Palakkad,6086,5838,248,30
06-03-2021,Malappuram,18447,18199,248,84
06-03-2021,Kozhikode,19409,18915,494,52
06-03-2021,Wayanad,4655,4539,116,13
06-03-2021,Kannur,9677,9346,331,43
06-03-2021,Kasaragod,6900,6669,231,21
06-03-2021,total,177062,170954,6108,616
07-03-2021,Thiruvananthapuram,18382,17680,702,54
07-03-2021,Kollam,13179,12772,407,43
07-03-2021,Pathanamthitta,7836,7430,406,32
07-03-2021,Alappuzha,12790,12255,535,55
07-03-2021,Kottayam,11223,10723,500,83
07-03-2021,Idukki,3071,2887,184,16
07-03-2021,Ernakulam,19840,19224,616,117
07-03-2021,Thrissur,19839,19088,751,45
07-03-2021,Palakkad,5861,5628,233,18
07-03-2021,Malappuram,18281,18032,249,85
07-03-2021,Kozhikode,19030,18588,442,41
07-03-2021,Wayanad,4587,4479,108,7
07-03-2021,Kannur,10627,10296,331,45
07-03-2021,Kasaragod,7070,6840,230,15
07-03-2021,total,171616,165922,5694,656
08-03-2021,Thiruvananthapuram,17996,17326,670,56
08-03-2021,Kollam,12756,12375,381,43
08-03-2021,Pathanamthitta,7723,7326,397,49
08-03-2021,Alappuzha,12734,12197,537,69
08-03-2021,Kottayam,10568,10113,455,61
08-03-2021,Idukki,3065,2891,174,5
08-03-2021,Ernakulam,19388,18772,616,65
08-03-2021,Thrissur,19521,18821,700,46
08-03-2021,Palakkad,5676,5449,227,23
08-03-2021,Malappuram,17341,17094,247,83
08-03-2021,Kozhikode,18421,17970,451,55
08-03-2021,Wayanad,4432,4331,101,11
08-03-2021,Kannur,11314,10988,326,39
08-03-2021,Kasaragod,7570,7340,230,11
08-03-2021,total,168505,162993,5512,616
09-03-2021,Thiruvananthapuram,17822,17197,625,53
09-03-2021,Kollam,12737,12385,352,43
09-03-2021,Pathanamthitta,7199,6823,376,36
09-03-2021,Alappuzha,11878,11357,521,44
09-03-2021,Kottayam,10679,10236,443,33
09-03-2021,Idukki,3329,3170,159,6
09-03-2021,Ernakulam,18496,17924,572,65
09-03-2021,Thrissur,19119,18480,639,45
09-03-2021,Palakkad,5625,5405,220,15
09-03-2021,Malappuram,17120,16893,227,63
09-03-2021,Kozhikode,18411,17985,426,42
09-03-2021,Wayanad,4267,4181,86,8
09-03-2021,Kannur,11853,11526,327,42
09-03-2021,Kasaragod,7572,7336,236,14
09-03-2021,total,166107,160898,5209,509
12-03-2021,Thiruvananthapuram,17031,16418,613,53
12-03-2021,Kollam,12520,12197,323,25
12-03-2021,Pathanamthitta,6320,5972,348,32
12-03-2021,Alappuzha,11879,11443,436,50
12-03-2021,Kottayam,11005,10574,431,63
12-03-2021,Idukki,3440,3317,123,11
12-03-2021,Ernakulam,16392,15875,517,25
12-03-2021,Thrissur,15297,14697,600,44
12-03-2021,Palakkad,5360,5146,214,19
12-03-2021,Malappuram,17178,16933,245,81
12-03-2021,Kozhikode,17815,17456,359,38
12-03-2021,Wayanad,4210,4136,74,6
12-03-2021,Kannur,11809,11509,300,32
12-03-2021,Kasaragod,7333,7087,246,17
12-03-2021,total,157589,152760,4829,496
13-03-2021,Thiruvananthapuram,16976,16364,612,49
13-03-2021,Kollam,12271,11971,300,33
13-03-2021,Pathanamthitta,6009,5679,330,34
13-03-2021,Alappuzha,12051,11627,424,49
13-03-2021,Kottayam,10858,10455,403,37
13-03-2021,Idukki,3451,3331,120,22
13-03-2021,Ernakulam,15048,14597,451,24
13-03-2021,Thrissur,13802,13381,421,54
13-03-2021,Palakkad,5349,5135,214,11
13-03-2021,Malappuram,17109,16888,221,57
13-03-2021,Kozhikode,17573,17213,360,40
13-03-2021,Wayanad,4172,4113,59,11
13-03-2021,Kannur,11962,11673,289,35
13-03-2021,Kasaragod,7182,6934,248,15
13-03-2021,total,153813,149361,4452,471
14-03-2021,Thiruvananthapuram,17250,16634,616,68
14-03-2021,Kollam,11943,11650,293,29
14-03-2021,Pathanamthitta,5855,5530,325,23
14-03-2021,Alappuzha,11484,11087,397,21
14-03-2021,Kottayam,10986,10597,389,62
14-03-2021,Idukki,3502,3381,121,10
14-03-2021,Ernakulam,14970,14513,457,51
14-03-2021,Thrissur,12392,12004,388,38
14-03-2021,Palakkad,5107,4902,205,29
14-03-2021,Malappuram,17040,16818,222,58
14-03-2021,Kozhikode,16997,16658,339,33
14-03-2021,Wayanad,3809,3749,60,9
14-03-2021,Kannur,11895,11608,287,32
14-03-2021,Kasaragod,7082,6851,231,9
14-03-2021,total,150312,145982,4330,472
16-03-2021,Thiruvananthapuram,17143,16559,584,54
16-03-2021,Kollam,12251,11964,287,44
16-03-2021,Pathanamthitta,4480,4202,278,27
16-03-2021,Alappuzha,11409,11057,352,39
16-03-2021,Kottayam,8071,7716,355,36
16-03-2021,Idukki,3697,3574,123,18
16-03-2021,Ernakulam,12122,11721,401,70
16-03-2021,Thrissur,10746,10432,314,23
16-03-2021,Palakkad,2923,2729,194,17
16-03-2021,Malappuram,16535,16338,197,34
16-03-2021,Kozhikode,16366,16039,327,42
16-03-2021,Wayanad,3494,3431,63,8
16-03-2021,Kannur,11641,11362,279,26
16-03-2021,Kasaragod,6345,6123,222,2
16-03-2021,total,137223,133247,3976,440
17-03-2021,Thiruvananthapuram,17359,16771,588,43
17-03-2021,Kollam,12167,11872,295,42
17-03-2021,Pathanamthitta,4472,4206,266,21
17-03-2021,Alappuzha,11256,10939,317,43
17-03-2021,Kottayam,8176,7758,418,81
17-03-2021,Idukki,3764,3637,127,15
17-03-2021,Ernakulam,11932,11540,392,52
17-03-2021,Thrissur,10335,10034,301,34
17-03-2021,Palakkad,2860,2665,195,18
17-03-2021,Malappuram,16430,16263,167,32
17-03-2021,Kozhikode,16101,15785,316,34
17-03-2021,Wayanad,3383,3318,65,12
17-03-2021,Kannur,11637,11379,258,28
17-03-2021,Kasaragod,6032,5805,227,18
17-03-2021,total,135904,131972,3932,473
20-03-2021,Thiruvananthapuram,16879,16285,594,64
20-03-2021,Kollam,11414,11144,270,31
20-03-2021,Pathanamthitta,4182,3933,249,25
20-03-2021,Alappuzha,7560,7286,274,29
20-03-2021,Kottayam,8244,7901,343,38
20-03-2021,Idukki,3918,3768,150,13
20-03-2021,Ernakulam,10784,10396,388,48
20-03-2021,Thrissur,9145,8856,289,37
20-03-2021,Palakkad,5207,4993,214,26
20-03-2021,Malappuram,16483,16330,153,29
20-03-2021,Kozhikode,15670,15363,307,36
20-03-2021,Wayanad,2940,2872,68,5
20-03-2021,Kannur,11464,11229,235,30
20-03-2021,Kasaragod,6129,5899,230,16
20-03-2021,total,130019,126255,3764,427
21-03-2021,Thiruvananthapuram,17066,16490,576,46
21-03-2021,Kollam,10995,10724,271,21
21-03-2021,Pathanamthitta,3966,3729,237,29
21-03-2021,Alappuzha,7117,6846,271,28
21-03-2021,Kottayam,7716,7362,354,79
21-03-2021,Idukki,3988,3836,152,14
21-03-2021,Ernakulam,10732,10350,382,32
21-03-2021,Thrissur,8825,8537,288,31
21-03-2021,Palakkad,4535,4332,203,22
21-03-2021,Malappuram,16691,16527,164,25
21-03-2021,Kozhikode,16069,15785,284,33
21-03-2021,Wayanad,2945,2879,66,6
21-03-2021,Kannur,11550,11305,245,23
21-03-2021,Kasaragod,6042,5807,235,21
21-03-2021,total,128237,124509,3728,410
22-03-2021,Thiruvananthapuram,17107,16554,553,34
22-03-2021,Kollam,11161,10872,289,42
22-03-2021,Pathanamthitta,3953,3716,237,14
22-03-2021,Alappuzha,5786,5508,278,42
22-03-2021,Kottayam,7285,6943,342,77
22-03-2021,Idukki,3969,3806,163,21
22-03-2021,Ernakulam,10347,9974,373,19
22-03-2021,Thrissur,8388,8100,288,41
22-03-2021,Palakkad,4678,4479,199,12
22-03-2021,Malappuram,16614,16455,159,36
22-03-2021,Kozhikode,15990,15679,311,28
22-03-2021,Wayanad,2978,2906,72,16
22-03-2021,Kannur,11630,11384,246,33
22-03-2021,Kasaragod,6239,6006,233,12
22-03-2021,total,126125,122382,3743,427
23-03-2021,Thiruvananthapuram,17095,16535,560,74
23-03-2021,Kollam,11121,10851,270,38
23-03-2021,Pathanamthitta,3916,3696,220,11
23-03-2021,Alappuzha,5784,5519,265,32
23-03-2021,Kottayam,7333,7004,329,40
23-03-2021,Idukki,4214,4059,155,13
23-03-2021,Ernakulam,10198,9822,376,42
23-03-2021,Thrissur,8359,8102,257,29
23-03-2021,Palakkad,4725,4527,198,21
23-03-2021,Malappuram,16288,16122,166,37
23-03-2021,Kozhikode,16132,15821,311,47
23-03-2021,Wayanad,2924,2853,71,12
23-03-2021,Kannur,11815,11568,247,33
23-03-2021,Kasaragod,6359,6131,228,12
23-03-2021,total,126263,122610,3653,441
25-03-2021,Thiruvananthapuram,16953,16409,544,61
25-03-2021,Kollam,11011,10782,229,23
25-03-2021,Pathanamthitta,4375,4152,223,23
25-03-2021,Alappuzha,5831,5570,261,40
25-03-2021,Kottayam,7557,7201,356,68
25-03-2021,Idukki,4256,4107,149,15
25-03-2021,Ernakulam,10150,9754,396,102
25-03-2021,Thrissur,8371,8118,253,32
25-03-2021,Palakkad,4799,4593,206,15
25-03-2021,Malappuram,16386,16213,173,40
25-03-2021,Kozhikode,15866,15508,358,46
25-03-2021,Wayanad,2898,2820,78,9
25-03-2021,Kannur,12300,12024,276,34
25-03-2021,Kasaragod,6352,6108,244,26
25-03-2021,total,127105,123359,3746,534
26-03-2021,Thiruvananthapuram,16865,16320,545,74
26-03-2021,Kollam,10821,10593,228,43
26-03-2021,Pathanamthitta,4368,4131,237,26
26-03-2021,Alappuzha,5995,5732,263,33
26-03-2021,Kottayam,7840,7505,335,72
26-03-2021,Idukki,4193,4044,149,13
26-03-2021,Ernakulam,10337,9935,402,53
26-03-2021,Thrissur,8175,7909,266,40
26-03-2021,Palakkad,4914,4695,219,22
26-03-2021,Malappuram,16295,16116,179,42
26-03-2021,Kozhikode,15921,15561,360,50
26-03-2021,Wayanad,2938,2862,76,8
26-03-2021,Kannur,12429,12148,281,31
26-03-2021,Kasaragod,6451,6200,251,12
26-03-2021,total,127542,123751,3791,519
27-03-2021,Thiruvananthapuram,16705,16164,541,59
27-03-2021,Kollam,10477,10248,229,25
27-03-2021,Pathanamthitta,4325,4105,220,22
27-03-2021,Alappuzha,6109,5874,235,23
27-03-2021,Kottayam,7610,7239,371,43
27-03-2021,Idukki,4405,4254,151,17
27-03-2021,Ernakulam,10700,10292,408,94
27-03-2021,Thrissur,8357,8089,268,35
27-03-2021,Palakkad,5033,4816,217,13
27-03-2021,Malappuram,16320,16136,184,44
27-03-2021,Kozhikode,16174,15804,370,43
27-03-2021,Wayanad,2977,2900,77,7
27-03-2021,Kannur,12654,12351,303,40
27-03-2021,Kasaragod,6440,6180,260,18
27-03-2021,total,128286,124452,3834,483
28-03-2021,Thiruvananthapuram,17021,16497,524,42
28-03-2021,Kollam,10211,9973,238,39
28-03-2021,Pathanamthitta,4252,4044,208,22
28-03-2021,Alappuzha,6238,5994,244,32
28-03-2021,Kottayam,7288,6912,376,75
28-03-2021,Idukki,4229,4075,154,17
28-03-2021,Ernakulam,10555,10161,394,79
28-03-2021,Thrissur,8697,8426,271,42
28-03-2021,Palakkad,4860,4639,221,30
28-03-2021,Malappuram,16466,16272,194,46
28-03-2021,Kozhikode,16849,16460,389,40
28-03-2021,Wayanad,3010,2937,73,9
28-03-2021,Kannur,12923,12608,315,36
28-03-2021,Kasaragod,6665,6394,271,15
28-03-2021,total,129264,125392,3872,524
29-03-2021,Thiruvananthapuram,16688,16163,525,43
29-03-2021,Kollam,10218,9985,233,31
29-03-2021,Pathanamthitta,4583,4371,212,15
29-03-2021,Alappuzha,6098,5861,237,31
29-03-2021,Kottayam,7238,6852,386,79
29-03-2021,Idukki,4187,4032,155,12
29-03-2021,Ernakulam,11359,10961,398,70
29-03-2021,Thrissur,8924,8651,273,34
29-03-2021,Palakkad,4785,4575,210,11
29-03-2021,Malappuram,16695,16493,202,65
29-03-2021,Kozhikode,16950,16547,403,32
29-03-2021,Wayanad,3055,2984,71,15
29-03-2021,Kannur,13326,13011,315,32
29-03-2021,Kasaragod,6979,6726,253,17
29-03-2021,total,131085,127212,3873,487
30-03-2021,Thiruvananthapuram,16350,15801,549,68
30-03-2021,Kollam,9933,9698,235,31
30-03-2021,Pathanamthitta,4405,4196,209,23
30-03-2021,Alappuzha,6096,5868,228,23
30-03-2021,Kottayam,7507,7130,377,51
30-03-2021,Idukki,4098,3946,152,20
30-03-2021,Ernakulam,11378,10975,403,72
30-03-2021,Thrissur,9051,8793,258,36
30-03-2021,Palakkad,5016,4810,206,14
30-03-2021,Malappuram,16943,16753,190,52
30-03-2021,Kozhikode,17392,16984,408,46
30-03-2021,Wayanad,3187,3115,72,7
30-03-2021,Kannur,13622,13310,312,40
30-03-2021,Kasaragod,7377,7115,262,15
30-03-2021,total,132355,128494,3861,498
31-03-2021,Thiruvananthapuram,16589,16008,581,81
31-03-2021,Kollam,10056,9811,245,44
31-03-2021,Pathanamthitta,4591,4386,205,12
31-03-2021,Alappuzha,5845,5640,205,18
31-03-2021,Kottayam,7966,7549,417,96
31-03-2021,Idukki,4141,3988,153,19
31-03-2021,Ernakulam,10982,10553,429,64
31-03-2021,Thrissur,9356,9092,264,45
31-03-2021,Palakkad,5540,5311,229,23
31-03-2021,Malappuram,17556,17350,206,84
31-03-2021,Kozhikode,17608,17191,417,52
31-03-2021,Wayanad,3269,3193,76,6
31-03-2021,Kannur,14212,13884,328,41
31-03-2021,Kasaragod,7364,7101,263,16
31-03-2021,total,135075,131057,4018,601
01-04-2021,Thiruvananthapuram,16512,15950,562,43
01-04-2021,Kollam,9702,9449,253,29
01-04-2021,Pathanamthitta,4502,4288,214,23
01-04-2021,Alappuzha,5714,5540,174,11
01-04-2021,Kottayam,8305,7906,399,66
01-04-2021,Idukki,4150,3981,169,28
01-04-2021,Ernakulam,11975,11524,451,60
01-04-2021,Thrissur,9555,9279,276,42
01-04-2021,Palakkad,5580,5346,234,31
01-04-2021,Malappuram,17867,17634,233,57
01-04-2021,Kozhikode,18087,17664,423,50
01-04-2021,Wayanad,3436,3360,76,14
01-04-2021,Kannur,14501,14158,343,48
01-04-2021,Kasaragod,7413,7119,294,36
01-04-2021,total,137299,133198,4101,538
02-04-2021,Thiruvananthapuram,16770,16208,562,61
02-04-2021,Kollam,9694,9444,250,33
02-04-2021,Pathanamthitta,4534,4327,207,15
02-04-2021,Alappuzha,5811,5612,199,49
02-04-2021,Kottayam,9058,8669,389,99
02-04-2021,Idukki,3984,3794,190,29
02-04-2021,Ernakulam,11705,11236,469,115
02-04-2021,Thrissur,10008,9710,298,52
02-04-2021,Palakkad,5250,5022,228,29
02-04-2021,Malappuram,18092,17858,234,59
02-04-2021,Kozhikode,18244,17818,426,64
02-04-2021,Wayanad,3478,3402,76,9
02-04-2021,Kannur,15165,14812,353,53
02-04-2021,Kasaragod,8044,7753,291,17
02-04-2021,total,139837,135665,4172,684
04-04-2021,Thiruvananthapuram,16807,16232,575,52
04-04-2021,Kollam,9794,9537,257,34
04-04-2021,Pathanamthitta,4727,4542,185,19
04-04-2021,Alappuzha,5610,5394,216,24
04-04-2021,Kottayam,9680,9250,430,78
04-04-2021,Idukki,3641,3466,175,22
04-04-2021,Ernakulam,12516,11985,531,53
04-04-2021,Thrissur,10340,10028,312,51
04-04-2021,Palakkad,4615,4360,255,40
04-04-2021,Malappuram,18258,18013,245,66
04-04-2021,Kozhikode,19206,18756,450,47
04-04-2021,Wayanad,3626,3551,75,14
04-04-2021,Kannur,15959,15561,398,41
04-04-2021,Kasaragod,8075,7776,299,13
04-04-2021,total,142854,138451,4403,554
05-04-2021,Thiruvananthapuram,16649,16077,572,45
05-04-2021,Kollam,9800,9536,264,47
05-04-2021,Pathanamthitta,4874,4691,183,17
05-04-2021,Alappuzha,5500,5288,212,29
05-04-2021,Kottayam,10487,10051,436,147
05-04-2021,Idukki,3803,3617,186,26
05-04-2021,Ernakulam,13577,13020,557,59
05-04-2021,Thrissur,10461,10123,338,48
05-04-2021,Palakkad,4550,4283,267,31
05-04-2021,Malappuram,18050,17789,261,84
05-04-2021,Kozhikode,19708,19238,470,62
05-04-2021,Wayanad,3571,3500,71,7
05-04-2021,Kannur,16601,16193,408,42
05-04-2021,Kasaragod,8715,8397,318,39
05-04-2021,total,146346,141803,4543,683
06-04-2021,Thiruvananthapuram,16539,15957,582,82
06-04-2021,Kollam,9658,9415,243,41
06-04-2021,Pathanamthitta,4752,4589,163,13
06-04-2021,Alappuzha,5550,5350,200,18
06-04-2021,Kottayam,11034,10535,499,72
06-04-2021,Idukki,4022,3831,191,24
06-04-2021,Ernakulam,13845,13253,592,82
06-04-2021,Thrissur,10666,10314,352,55
06-04-2021,Palakkad,4598,4318,280,36
06-04-2021,Malappuram,18208,17941,267,87
06-04-2021,Kozhikode,20851,20345,506,49
06-04-2021,Wayanad,3743,3660,83,18
06-04-2021,Kannur,16834,16405,429,52
06-04-2021,Kasaragod,9068,8730,338,21
06-04-2021,total,149368,144643,4725,650
10-04-2021,Thiruvananthapuram,16925,16202,723,102
10-04-2021,Kollam,9993,9699,294,68
10-04-2021,Pathanamthitta,4825,4580,245,32
10-04-2021,Alappuzha,7208,6884,324,67
10-04-2021,Kottayam,12656,11986,670,122
10-04-2021,Idukki,4858,4608,250,47
10-04-2021,Ernakulam,18305,17516,789,121
10-04-2021,Thrissur,11999,11525,474,79
10-04-2021,Palakkad,5445,5109,336,51
10-04-2021,Malappuram,18871,18567,304,93
10-04-2021,Kozhikode,22322,21765,557,97
10-04-2021,Wayanad,4430,4304,126,26
10-04-2021,Kannur,17512,17029,483,55
10-04-2021,Kasaragod,9545,9214,331,22
10-04-2021,total,164894,158988,5906,982
11-04-2021,Thiruvananthapuram,17997,17209,788,145
11-04-2021,Kollam,10391,10072,319,78
11-04-2021,Pathanamthitta,4660,4424,236,28
11-04-2021,Alappuzha,7466,7075,391,67
11-04-2021,Kottayam,13719,12981,738,146
11-04-2021,Idukki,4956,4681,275,45
11-04-2021,Ernakulam,19255,18393,862,110
11-04-2021,Thrissur,12402,11875,527,98
11-04-2021,Palakkad,5457,5061,396,70
11-04-2021,Malappuram,19667,19343,324,112
11-04-2021,Kozhikode,23371,22719,652,126
11-04-2021,Wayanad,4575,4429,146,30
11-04-2021,Kannur,17521,17032,489,55
11-04-2021,Kasaragod,9373,9031,342,23
11-04-2021,total,170810,164325,6485,1133
12-04-2021,Thiruvananthapuram,18903,18058,845,163
12-04-2021,Kollam,10889,10550,339,49
12-04-2021,Pathanamthitta,4598,4305,293,52
12-04-2021,Alappuzha,7994,7577,417,76
12-04-2021,Kottayam,12557,11773,784,216
12-04-2021,Idukki,4880,4599,281,24
12-04-2021,Ernakulam,20886,19930,956,137
12-04-2021,Thrissur,12746,12132,614,132
12-04-2021,Palakkad,5990,5530,460,97
12-04-2021,Malappuram,19777,19425,352,118
12-04-2021,Kozhikode,24059,23382,677,93
12-04-2021,Wayanad,5083,4934,149,20
12-04-2021,Kannur,17653,17158,495,58
12-04-2021,Kasaragod,9841,9474,367,35
12-04-2021,total,175856,168827,7029,1270
13-04-2021,Thiruvananthapuram,19416,18431,985,220
13-04-2021,Kollam,11097,10707,390,98
13-04-2021,Pathanamthitta,4987,4692,295,50
13-04-2021,Alappuzha,8834,8340,494,89
13-04-2021,Kottayam,13175,12342,833,162
13-04-2021,Idukki,5096,4799,297,52
13-04-2021,Ernakulam,21596,20555,1041,168
13-04-2021,Thrissur,13081,12425,656,89
13-04-2021,Palakkad,6128,5657,471,50
13-04-2021,Malappuram,20277,19903,374,115
13-04-2021,Kozhikode,24769,24058,711,93
13-04-2021,Wayanad,5510,5359,151,19
13-04-2021,Kannur,18495,17989,506,60
13-04-2021,Kasaragod,10128,9750,378,24
13-04-2021,total,182589,175007,7582,1289
14-04-2021,Thiruvananthapuram,20594,19503,1091,175
14-04-2021,Kollam,11655,11209,446,93
14-04-2021,Pathanamthitta,4973,4591,382,87
14-04-2021,Alappuzha,9916,9330,586,120
14-04-2021,Kottayam,13449,12588,861,181
14-04-2021,Idukki,5256,4942,314,45
14-04-2021,Ernakulam,23322,22200,1122,126
14-04-2021,Thrissur,13408,12711,697,113
14-04-2021,Palakkad,6904,6393,511,68
14-04-2021,Malappuram,20678,20261,417,123
14-04-2021,Kozhikode,25471,24701,770,102
14-04-2021,Wayanad,5841,5673,168,27
14-04-2021,Kannur,18602,18075,527,64
14-04-2021,Kasaragod,10130,9696,434,60
14-04-2021,total,190199,181873,8326,1384
15-04-2021,Thiruvananthapuram,21663,20460,1203,204
15-04-2021,Kollam,12140,11677,463,62
15-04-2021,Pathanamthitta,5032,4621,411,74
15-04-2021,Alappuzha,10078,9402,676,108
15-04-2021,Kottayam,13426,12503,923,257
15-04-2021,Idukki,5671,5316,355,63
15-04-2021,Ernakulam,25025,23810,1215,147
15-04-2021,Thrissur,13803,13015,788,144
15-04-2021,Palakkad,7067,6528,539,70
15-04-2021,Malappuram,21090,20660,430,125
15-04-2021,Kozhikode,25777,25034,743,81
15-04-2021,Wayanad,6010,5842,168,25
15-04-2021,Kannur,18492,17964,528,65
15-04-2021,Kasaragod,9534,9061,473,54
15-04-2021,total,194808,185893,8915,1479
16-04-2021,Thiruvananthapuram,23175,21813,1362,238
16-04-2021,Kollam,12254,11745,509,88
16-04-2021,Pathanamthitta,4935,4462,473,82
16-04-2021,Alappuzha,11023,10270,753,97
16-04-2021,Kottayam,15495,14515,980,215
16-04-2021,Idukki,6054,5661,393,53
16-04-2021,Ernakulam,27097,25750,1347,222
16-04-2021,Thrissur,14391,13529,862,153
16-04-2021,Palakkad,7764,7140,624,62
16-04-2021,Malappuram,21759,21292,467,127
16-04-2021,Kozhikode,26954,26146,808,127
16-04-2021,Wayanad,6606,6404,202,46
16-04-2021,Kannur,18338,17773,565,79
16-04-2021,Kasaragod,9088,8596,492,22
16-04-2021,total,204933,195096,9837,1611
18-04-2021,Thiruvananthapuram,26705,25204,1501,175
18-04-2021,Kollam,13185,12605,580,102
18-04-2021,Pathanamthitta,6184,5624,560,85
18-04-2021,Alappuzha,13958,13034,924,169
18-04-2021,Kottayam,18295,17162,1133,215
18-04-2021,Idukki,7106,6681,425,66
18-04-2021,Ernakulam,31989,30496,1493,149
18-04-2021,Thrissur,17420,16305,1115,258
18-04-2021,Palakkad,10287,9598,689,106
18-04-2021,Malappuram,23488,22903,585,215
18-04-2021,Kozhikode,30161,29139,1022,194
18-04-2021,Wayanad,7988,7753,235,45
18-04-2021,Kannur,20610,20025,585,99
18-04-2021,Kasaragod,9660,9154,506,38
18-04-2021,total,237036,225683,11353,1916
20-04-2021,Thiruvananthapuram,31423,29757,1666,329
20-04-2021,Kollam,15050,14375,675,124
20-04-2021,Pathanamthitta,6949,6232,717,169
20-04-2021,Alappuzha,16157,15065,1092,119
20-04-2021,Kottayam,22993,21612,1381,337
20-04-2021,Idukki,7528,6995,533,89
20-04-2021,Ernakulam,45482,43943,1539,242
20-04-2021,Thrissur,22423,20908,1515,309
20-04-2021,Palakkad,16079,15299,780,102
20-04-2021,Malappuram,26748,26073,675,220
20-04-2021,Kozhikode,34815,33597,1218,229
20-04-2021,Wayanad,9761,9480,281,55
20-04-2021,Kannur,23784,23139,645,112
20-04-2021,Kasaragod,9993,9489,504,34
20-04-2021,total,289185,275964,13221,2470
24-04-2021,Thiruvananthapuram,44737,42467,2270,284
24-04-2021,Kollam,18479,17566,913,129
24-04-2021,Pathanamthitta,8788,7601,1187,157
24-04-2021,Alappuzha,24411,23064,1347,198
24-04-2021,Kottayam,36998,35159,1839,848
24-04-2021,Idukki,10672,10092,580,38
24-04-2021,Ernakulam,70990,68947,2043,192
24-04-2021,Thrissur,38272,36043,2229,490
24-04-2021,Palakkad,26373,25079,1294,294
24-04-2021,Malappuram,35871,35039,832,272
24-04-2021,Kozhikode,55464,53525,1939,303
24-04-2021,Wayanad,15578,15063,515,117
24-04-2021,Kannur,33770,32965,805,108
24-04-2021,Kasaragod,11184,10562,622,46
24-04-2021,total,431587,413172,18415,3476
25-04-2021,Thiruvananthapuram,48572,46128,2444,427
25-04-2021,Kollam,19578,18589,989,151
25-04-2021,Pathanamthitta,8920,7636,1284,206
25-04-2021,Alappuzha,26625,25061,1564,247
25-04-2021,Kottayam,40929,38964,1965,655
25-04-2021,Idukki,11266,10698,568,40
25-04-2021,Ernakulam,76599,74453,2146,209
25-04-2021,Thrissur,42233,39899,2334,316
25-04-2021,Palakkad,28106,26767,1339,176
25-04-2021,Malappuram,38702,37833,869,286
25-04-2021,Kozhikode,63726,61680,2046,351
25-04-2021,Wayanad,17207,16659,548,81
25-04-2021,Kannur,36873,36046,827,100
25-04-2021,Kasaragod,11222,10580,642,34
25-04-2021,total,470558,450993,19565,3279
01-05-2021,Thiruvananthapuram,70481,67049,3432,506
01-05-2021,Kollam,25094,23760,1334,185
01-05-2021,Pathanamthitta,12108,10545,1563,196
01-05-2021,Alappuzha,35952,34124,1828,198
01-05-2021,Kottayam,60569,57968,2601,1470
01-05-2021,Idukki,15947,15402,545,42
01-05-2021,Ernakulam,102798,99372,3426,557
01-05-2021,Thrissur,74528,72043,2485,336
01-05-2021,Palakkad,44265,42687,1578,199
01-05-2021,Malappuram,51936,50484,1452,378
01-05-2021,Kozhikode,102999,100210,2789,329
01-05-2021,Wayanad,27259,26577,682,85
01-05-2021,Kannur,51352,50352,1000,160
01-05-2021,Kasaragod,12555,11944,611,34
01-05-2021,total,687843,662517,25326,4675
02-05-2021,Thiruvananthapuram,74024,70452,3572,522
02-05-2021,Kollam,25978,24585,1393,192
02-05-2021,Pathanamthitta,11894,10412,1482,196
02-05-2021,Alappuzha,38681,36846,1835,292
02-05-2021,Kottayam,62023,59290,2733,52
02-05-2021,Idukki,16786,16208,578,50
02-05-2021,Ernakulam,104085,100622,3463,258
02-05-2021,Thrissur,79975,77439,2536,385
02-05-2021,Palakkad,50151,48527,1624,301
02-05-2021,Malappuram,56609,55006,1603,356
02-05-2021,Kozhikode,108404,105472,2932,432
02-05-2021,Wayanad,28336,27604,732,155
02-05-2021,Kannur,53033,51977,1056,144
02-05-2021,Kasaragod,14632,14002,630,36
02-05-2021,total,724611,698442,26169,3371
03-05-2021,Thiruvananthapuram,76752,72938,3814,416
03-05-2021,Kollam,26683,25254,1429,158
03-05-2021,Pathanamthitta,12416,10861,1555,166
03-05-2021,Alappuzha,39342,37418,1924,259
03-05-2021,Kottayam,60827,57973,2854,121
03-05-2021,Idukki,17522,16936,586,37
03-05-2021,Ernakulam,103080,99502,3578,271
03-05-2021,Thrissur,83347,80606,2741,619
03-05-2021,Palakkad,53247,51564,1683,221
03-05-2021,Malappuram,58264,56596,1668,291
03-05-2021,Kozhikode,110923,108064,2859,277
03-05-2021,Wayanad,29229,28506,723,78
03-05-2021,Kannur,54126,52982,1144,147
03-05-2021,Kasaragod,14377,13754,623,30
03-05-2021,total,740135,712954,27181,3091
05-05-2021,Thiruvananthapuram,80616,76439,4177,620
05-05-2021,Kollam,28642,27022,1620,190
05-05-2021,Pathanamthitta,12663,11173,1490,178
05-05-2021,Alappuzha,41887,39965,1922,142
05-05-2021,Kottayam,61937,59081,2856,67
05-05-2021,Idukki,18324,17680,644,60
05-05-2021,Ernakulam,102517,98529,3988,641
05-05-2021,Thrissur,92138,89310,2828,468
05-05-2021,Palakkad,61435,59471,1964,316
05-05-2021,Malappuram,62063,60556,1507,468
05-05-2021,Kozhikode,117230,114099,3131,408
05-05-2021,Wayanad,30620,29817,803,125
05-05-2021,Kannur,56857,55649,1208,158
05-05-2021,Kasaragod,17264,16662,602,27
05-05-2021,total,784193,755453,28740,3868
06-05-2021,Thiruvananthapuram,83338,79025,4313,624
06-05-2021,Kollam,31065,29367,1698,247
06-05-2021,Pathanamthitta,13090,11539,1551,191
06-05-2021,Alappuzha,44914,42848,2066,327
06-05-2021,Kottayam,62677,59608,3069,84
06-05-2021,Idukki,19388,18714,674,80
06-05-2021,Ernakulam,104037,99949,4088,275
06-05-2021,Thrissur,97367,94511,2856,406
06-05-2021,Palakkad,66298,64295,2003,236
06-05-2021,Malappuram,65138,63528,1610,375
06-05-2021,Kozhikode,123320,120066,3254,445
06-05-2021,Wayanad,31662,30794,868,158
06-05-2021,Kannur,58555,57339,1216,158
06-05-2021,Kasaragod,17562,16946,616,27
06-05-2021,total,818411,788529,29882,3633
11-05-2021,Thiruvananthapuram,95115,90139,4976,671
11-05-2021,Kollam,40736,38516,2220,426
11-05-2021,Pathanamthitta,26608,25125,1483,222
11-05-2021,Alappuzha,58369,55980,2389,348
11-05-2021,Kottayam,69433,66126,3307,67
11-05-2021,Idukki,23859,23102,757,13
11-05-2021,Ernakulam,140614,136011,4603,468
11-05-2021,Thrissur,120275,117189,3086,482
11-05-2021,Palakkad,87988,85606,2382,216
11-05-2021,Malappuram,72811,70284,2527,266
11-05-2021,Kozhikode,129285,125977,3308,415
11-05-2021,Wayanad,35564,34512,1052,189
11-05-2021,Kannur,71233,69864,1369,193
11-05-2021,Kasaragod,21423,20733,690,31
11-05-2021,total,993313,959164,34149,4007
12-05-2021,Thiruvananthapuram,96221,91157,5064,576
12-05-2021,Kollam,42492,40094,2398,453
12-05-2021,Pathanamthitta,27409,25862,1547,120
12-05-2021,Alappuzha,61111,58735,2376,369
12-05-2021,Kottayam,70028,66544,3484,91
12-05-2021,Idukki,22702,22001,701,23
12-05-2021,Ernakulam,130781,126098,4683,321
12-05-2021,Thrissur,124360,121312,3048,451
12-05-2021,Palakkad,90849,88467,2382,197
12-05-2021,Malappuram,74480,72457,2023,202
12-05-2021,Kozhikode,129920,126498,3422,452
12-05-2021,Wayanad,35194,34071,1123,182
12-05-2021,Kannur,72948,71537,1411,104
12-05-2021,Kasaragod,23152,22378,774,52
12-05-2021,total,1001647,967211,34436,3593
13-05-2021,Thiruvananthapuram,96724,91515,5209,524
13-05-2021,Kollam,45061,42466,2595,470
13-05-2021,Pathanamthitta,29053,27490,1563,105
13-05-2021,Alappuzha,63452,60982,2470,430
13-05-2021,Kottayam,56975,53447,3528,122
13-05-2021,Idukki,23132,22452,680,28
13-05-2021,Ernakulam,122172,117461,4711,305
13-05-2021,Thrissur,128470,125285,3185,483
13-05-2021,Palakkad,96160,93847,2313,191
13-05-2021,Malappuram,76593,74456,2137,173
13-05-2021,Kozhikode,128714,125281,3433,541
13-05-2021,Wayanad,35858,34697,1161,167
13-05-2021,Kannur,74394,73051,1343,267
13-05-2021,Kasaragod,25685,24912,773,52
13-05-2021,total,1002443,967342,35101,3858
14-05-2021,Thiruvananthapuram,97433,91988,5445,802
14-05-2021,Kollam,46662,43838,2824,448
14-05-2021,Pathanamthitta,28985,27322,1663,117
14-05-2021,Alappuzha,61966,59547,2419,444
14-05-2021,Kottayam,57952,53360,4592,116
14-05-2021,Idukki,26181,25437,744,31
14-05-2021,Ernakulam,118486,113777,4709,229
14-05-2021,Thrissur,133389,130193,3196,499
14-05-2021,Palakkad,100718,98199,2519,325
14-05-2021,Malappuram,77183,74978,2205,246
14-05-2021,Kozhikode,124925,121382,3543,443
14-05-2021,Wayanad,35306,34113,1193,105
14-05-2021,Kannur,75824,74486,1338,151
14-05-2021,Kasaragod,29444,28637,807,62
14-05-2021,total,1014454,977257,37197,4018
15-05-2021,Thiruvananthapuram,96975,91395,5580,626
15-05-2021,Kollam,48623,45780,2843,438
15-05-2021,Pathanamthitta,28960,27271,1689,143
15-05-2021,Alappuzha,65129,62649,2480,401
15-05-2021,Kottayam,59453,55856,3597,100
15-05-2021,Idukki,26917,26131,786,22
15-05-2021,Ernakulam,122437,117515,4922,508
15-05-2021,Thrissur,137798,134623,3175,427
15-05-2021,Palakkad,104673,101998,2675,261
15-05-2021,Malappuram,75469,73168,2301,253
15-05-2021,Kozhikode,120345,116772,3573,377
15-05-2021,Wayanad,35380,34103,1277,178
15-05-2021,Kannur,77822,76410,1412,194
15-05-2021,Kasaragod,31290,30533,757,46
15-05-2021,total,1031271,994204,37067,3974
16-05-2021,Thiruvananthapuram,96131,90503,5628,639
16-05-2021,Kollam,50577,47735,2842,339
16-05-2021,Pathanamthitta,28666,27085,1581,73
16-05-2021,Alappuzha,65820,63313,2507,292
16-05-2021,Kottayam,60121,56482,3639,104
16-05-2021,Idukki,27477,26689,788,12
16-05-2021,Ernakulam,124086,119196,4890,370
16-05-2021,Thrissur,141978,138881,3097,386
16-05-2021,Palakkad,108979,106255,2724,294
16-05-2021,Malappuram,76241,73882,2359,263
16-05-2021,Kozhikode,119212,115622,3590,496
16-05-2021,Wayanad,35511,34211,1300,147
16-05-2021,Kannur,77798,76391,1407,177
16-05-2021,Kasaragod,31279,30514,765,48
16-05-2021,total,1043876,1006759,37117,3640
17-05-2021,Thiruvananthapuram,94983,89261,5722,594
17-05-2021,Kollam,51427,48391,3036,538
17-05-2021,Pathanamthitta,28465,26907,1558,89
17-05-2021,Alappuzha,65148,62726,2422,403
17-05-2021,Kottayam,61489,57835,3654,54
17-05-2021,Idukki,28595,27786,809,17
17-05-2021,Ernakulam,114796,109874,4922,242
17-05-2021,Thrissur,144496,141134,3362,351
17-05-2021,Palakkad,107504,104794,2710,398
17-05-2021,Malappuram,72334,69796,2538,212
17-05-2021,Kozhikode,114624,111068,3556,369
17-05-2021,Wayanad,28764,27514,1250,76
17-05-2021,Kannur,75849,74472,1377,249
17-05-2021,Kasaragod,30611,29812,799,38
17-05-2021,total,1019085,981370,37715,3630
19-05-2021,Thiruvananthapuram,94248,88344,5904,648
19-05-2021,Kollam,52919,49455,3464,495
19-05-2021,Pathanamthitta,28003,26389,1614,108
19-05-2021,Alappuzha,66675,64117,2558,273
19-05-2021,Kottayam,62798,59198,3600,158
19-05-2021,Idukki,31493,30642,851,25
19-05-2021,Ernakulam,113178,108484,4694,242
19-05-2021,Thrissur,149491,145607,3884,488
19-05-2021,Palakkad,108368,104527,3841,232
19-05-2021,Malappuram,66932,64242,2690,269
19-05-2021,Kozhikode,104976,101371,3605,358
19-05-2021,Wayanad,27098,25847,1251,161
19-05-2021,Kannur,67931,66441,1490,186
19-05-2021,Kasaragod,30974,30221,753,247
19-05-2021,total,1005084,964885,40199,3890
20-05-2021,Thiruvananthapuram,92426,86497,5929,707
20-05-2021,Kollam,52356,48784,3572,494
20-05-2021,Pathanamthitta,28113,26442,1671,95
20-05-2021,Alappuzha,65634,62977,2657,284
20-05-2021,Kottayam,63376,59791,3585,132
20-05-2021,Idukki,33169,32260,909,48
20-05-2021,Ernakulam,113680,108825,4855,466
20-05-2021,Thrissur,152046,149283,2763,464
20-05-2021,Palakkad,112281,109440,2841,292
20-05-2021,Malappuram,65640,62838,2802,304
20-05-2021,Kozhikode,98107,94528,3579,316
20-05-2021,Wayanad,26412,25128,1284,146
20-05-2021,Kannur,64005,62541,1464,178
20-05-2021,Kasaragod,32093,31319,774,46
20-05-2021,total,999338,960653,38685,3972
21-05-2021,Thiruvananthapuram,91404,85406,5998,567
21-05-2021,Kollam,52944,49348,3596,526
21-05-2021,Pathanamthitta,27975,26295,1680,110
21-05-2021,Alappuzha,64199,61552,2647,242
21-05-2021,Kottayam,59778,56128,3650,126
21-05-2021,Idukki,33980,33068,912,62
21-05-2021,Ernakulam,113174,108409,4765,217
21-05-2021,Thrissur,154308,151652,2656,436
21-05-2021,Palakkad,111515,108599,2916,296
21-05-2021,Malappuram,65780,62984,2796,245
21-05-2021,Kozhikode,93384,89872,3512,311
21-05-2021,Wayanad,25636,24292,1344,165
21-05-2021,Kannur,61408,59971,1437,158
21-05-2021,Kasaragod,32524,31724,800,63
21-05-2021,total,988009,949300,38709,3524
22-05-2021,Thiruvananthapuram,89710,83580,6130,576
22-05-2021,Kollam,52520,48890,3630,437
22-05-2021,Pathanamthitta,27800,26112,1688,89
22-05-2021,Alappuzha,62930,60451,2479,142
22-05-2021,Kottayam,55484,51937,3547,125
22-05-2021,Idukki,34841,33887,954,49
22-05-2021,Ernakulam,106818,101954,4864,332
22-05-2021,Thrissur,156415,153842,2573,464
22-05-2021,Palakkad,111323,108380,2943,311
22-05-2021,Malappuram,65660,62932,2728,130
22-05-2021,Kozhikode,88237,84824,3413,304
22-05-2021,Wayanad,25278,23804,1474,228
22-05-2021,Kannur,58220,56734,1486,157
22-05-2021,Kasaragod,34710,33876,834,39
22-05-2021,total,969946,931203,38743,3383
23-05-2021,Thiruvananthapuram,87945,81822,6123,492
23-05-2021,Kollam,53342,49675,3667,373
23-05-2021,Pathanamthitta,27466,25645,1821,152
23-05-2021,Alappuzha,63766,61294,2472,380
23-05-2021,Kottayam,54969,51415,3554,131
23-05-2021,Idukki,35395,34444,951,10
23-05-2021,Ernakulam,104871,99936,4935,314
23-05-2021,Thrissur,152902,150464,2438,425
23-05-2021,Palakkad,111624,108671,2953,299
23-05-2021,Malappuram,66020,63214,2806,232
23-05-2021,Kozhikode,84298,80858,3440,291
23-05-2021,Wayanad,24713,23158,1555,204
23-05-2021,Kannur,55630,54156,1474,221
23-05-2021,Kasaragod,33924,33046,878,82
23-05-2021,total,956865,917798,39067,3606
24-05-2021,Thiruvananthapuram,86134,79947,6187,663
24-05-2021,Kollam,52524,48879,3645,306
24-05-2021,Pathanamthitta,27845,26069,1776,95
24-05-2021,Alappuzha,61134,58663,2471,290
24-05-2021,Kottayam,52417,48962,3455,100
24-05-2021,Idukki,35191,34193,998,18
24-05-2021,Ernakulam,101972,97237,4735,185
24-05-2021,Thrissur,148847,146409,2438,518
24-05-2021,Palakkad,106294,103253,3041,358
24-05-2021,Malappuram,66150,63306,2844,192
24-05-2021,Kozhikode,80556,77105,3451,266
24-05-2021,Wayanad,23598,22059,1539,85
24-05-2021,Kannur,52349,50913,1436,128
24-05-2021,Kasaragod,33530,32632,898,44
24-05-2021,total,928541,889627,38914,3248
25-05-2021,Thiruvananthapuram,84479,72061,6209,660
25-05-2021,Kollam,50780,43486,3647,390
25-05-2021,Pathanamthitta,28092,24708,1692,36
25-05-2021,Alappuzha,60452,55504,2474,183
25-05-2021,Kottayam,52267,45413,3427,72
25-05-2021,Idukki,35767,33727,1020,20
25-05-2021,Ernakulam,99782,90064,4859,331
25-05-2021,Thrissur,144397,139729,2334,451
25-05-2021,Palakkad,106119,100191,2964,314
25-05-2021,Malappuram,65267,59525,2871,206
25-05-2021,Kozhikode,73750,67072,3339,258
25-05-2021,Wayanad,23262,20030,1616,173
25-05-2021,Kannur,48408,45688,1360,142
25-05-2021,Kasaragod,31356,29500,928,67
25-05-2021,total,904178,826698,38740,3303
26-05-2021,Thiruvananthapuram,82790,76396,6394,796
26-05-2021,Kollam,48873,45186,3687,441
26-05-2021,Pathanamthitta,27957,26152,1805,146
26-05-2021,Alappuzha,58805,56312,2493,250
26-05-2021,Kottayam,50560,47186,3374,162
26-05-2021,Idukki,36981,35899,1082,46
26-05-2021,Ernakulam,97574,92873,4701,416
26-05-2021,Thrissur,142870,140499,2371,471
26-05-2021,Palakkad,107118,104118,3000,335
26-05-2021,Malappuram,66540,63684,2856,166
26-05-2021,Kozhikode,68953,65614,3339,255
26-05-2021,Wayanad,22434,20844,1590,92
26-05-2021,Kannur,46638,45286,1352,191
26-05-2021,Kasaragod,31809,30833,976,56
26-05-2021,total,889902,850882,39020,3823
27-05-2021,Thiruvananthapuram,81036,74586,6450,700
27-05-2021,Kollam,49568,45990,3578,406
27-05-2021,Pathanamthitta,27805,25992,1813,131
27-05-2021,Alappuzha,57999,55409,2590,286
27-05-2021,Kottayam,49525,46192,3333,134
27-05-2021,Idukki,35956,34843,1113,73
27-05-2021,Ernakulam,95102,90341,4761,599
27-05-2021,Thrissur,141305,138964,2341,464
27-05-2021,Palakkad,108315,104409,3906,283
27-05-2021,Malappuram,65292,62330,2962,283
27-05-2021,Kozhikode,67978,64575,3403,278
27-05-2021,Wayanad,21861,20253,1608,143
27-05-2021,Kannur,44073,42738,1335,169
27-05-2021,Kasaragod,30769,29798,971,52
27-05-2021,total,876584,836420,40164,4001
28-05-2021,Thiruvananthapuram,79127,72789,6338,519
28-05-2021,Kollam,50965,47436,3529,377
28-05-2021,Pathanamthitta,27734,25918,1816,99
28-05-2021,Alappuzha,57175,54656,2519,193
28-05-2021,Kottayam,43881,40654,3227,75
28-05-2021,Idukki,35410,34257,1153,53
28-05-2021,Ernakulam,95111,90363,4748,630
28-05-2021,Thrissur,138823,136545,2278,435
28-05-2021,Palakkad,106692,103473,3219,435
28-05-2021,Malappuram,64892,61874,3018,240
28-05-2021,Kozhikode,64743,61393,3350,292
28-05-2021,Wayanad,19244,17683,1561,68
28-05-2021,Kannur,42745,41398,1347,192
28-05-2021,Kasaragod,30685,29678,1007,69
28-05-2021,total,857227,818117,39110,3677
29-05-2021,Thiruvananthapuram,78317,72233,6084,399
29-05-2021,Kollam,51455,47887,3568,453
29-05-2021,Pathanamthitta,27845,25956,1889,106
29-05-2021,Alappuzha,54115,51550,2565,283
29-05-2021,Kottayam,42082,39000,3082,105
29-05-2021,Idukki,30007,28840,1167,37
29-05-2021,Ernakulam,91208,86456,4752,669
29-05-2021,Thrissur,136702,134478,2224,429
29-05-2021,Palakkad,109160,105185,3975,398
29-05-2021,Malappuram,64040,60927,3113,236
29-05-2021,Kozhikode,61636,58247,3389,233
29-05-2021,Wayanad,18264,16757,1507,80
29-05-2021,Kannur,40952,39673,1279,166
29-05-2021,Kasaragod,30083,29211,872,30
29-05-2021,total,835866,796400,39466,3624
30-05-2021,Thiruvananthapuram,78279,72209,6070,410
30-05-2021,Kollam,51625,48110,3515,335
30-05-2021,Pathanamthitta,27623,25736,1887,106
30-05-2021,Alappuzha,53111,50601,2510,195
30-05-2021,Kottayam,40711,37660,3051,118
30-05-2021,Idukki,30026,28848,1178,43
30-05-2021,Ernakulam,88544,83812,4732,477
30-05-2021,Thrissur,135575,133418,2157,335
30-05-2021,Palakkad,105717,102325,3392,577
30-05-2021,Malappuram,63457,60353,3104,202
30-05-2021,Kozhikode,59196,55886,3310,271
30-05-2021,Wayanad,17762,16229,1533,109
30-05-2021,Kannur,37084,35847,1237,143
30-05-2021,Kasaragod,30707,29808,899,45
30-05-2021,total,819417,780842,38575,3366
31-05-2021,Thiruvananthapuram,76375,70305,6070,439
31-05-2021,Kollam,48233,44677,3556,336
31-05-2021,Pathanamthitta,27544,25599,1945,76
31-05-2021,Alappuzha,49604,47064,2540,295
31-05-2021,Kottayam,39790,36812,2978,139
31-05-2021,Idukki,28936,27701,1235,30
31-05-2021,Ernakulam,84801,80225,4576,213
31-05-2021,Thrissur,132324,130144,2180,440
31-05-2021,Palakkad,103105,99622,3483,358
31-05-2021,Malappuram,61791,58871,2920,128
31-05-2021,Kozhikode,58137,54831,3306,213
31-05-2021,Wayanad,16860,15377,1483,49
31-05-2021,Kannur,33533,32333,1200,114
31-05-2021,Kasaragod,27169,26264,905,51
31-05-2021,total,788202,749825,38377,2881
01-06-2021,Thiruvananthapuram,74173,68234,5939,462
01-06-2021,Kollam,46748,43351,3397,374
01-06-2021,Pathanamthitta,27422,25629,1793,54
01-06-2021,Alappuzha,50524,48004,2520,163
01-06-2021,Kottayam,37896,35055,2841,66
01-06-2021,Idukki,27693,26414,1279,21
01-06-2021,Ernakulam,82154,77557,4597,256
01-06-2021,Thrissur,130929,128812,2117,390
01-06-2021,Palakkad,99595,96161,3434,287
01-06-2021,Malappuram,59022,56251,2771,86
01-06-2021,Kozhikode,54791,51524,3267,238
01-06-2021,Wayanad,16145,14620,1525,110
01-06-2021,Kannur,30636,29461,1175,116
01-06-2021,Kasaragod,26280,25442,838,61
01-06-2021,total,764008,726515,37493,2684
02-06-2021,Thiruvananthapuram,71649,65844,5805,420
02-06-2021,Kollam,44771,41273,3498,389
02-06-2021,Pathanamthitta,27810,26009,1801,131
02-06-2021,Alappuzha,49070,46605,2465,188
02-06-2021,Kottayam,38551,35864,2687,69
02-06-2021,Idukki,27173,26010,1163,51
02-06-2021,Ernakulam,77392,72964,4428,284
02-06-2021,Thrissur,128680,126656,2024,331
02-06-2021,Palakkad,95568,92162,3406,323
02-06-2021,Malappuram,60195,57450,2745,152
02-06-2021,Kozhikode,52270,48963,3307,269
02-06-2021,Wayanad,15740,14265,1475,50
02-06-2021,Kannur,27912,26752,1160,136
02-06-2021,Kasaragod,25376,24558,818,47
02-06-2021,total,742157,705375,36782,2840
03-06-2021,Thiruvananthapuram,69182,63409,5773,503
03-06-2021,Kollam,44320,40962,3358,391
03-06-2021,Pathanamthitta,27668,25880,1788,98
03-06-2021,Alappuzha,47284,44862,2422,238
03-06-2021,Kottayam,37595,35067,2528,74
03-06-2021,Idukki,26258,25065,1193,51
03-06-2021,Ernakulam,71110,66942,4168,255
03-06-2021,Thrissur,126321,124316,2005,370
03-06-2021,Palakkad,93502,90091,3411,274
03-06-2021,Malappuram,59521,56615,2906,180
03-06-2021,Kozhikode,50822,47580,3242,201
03-06-2021,Wayanad,15100,13636,1464,69
03-06-2021,Kannur,26665,25544,1121,157
03-06-2021,Kasaragod,24680,23882,798,46
03-06-2021,total,720028,683851,36177,2907
04-06-2021,Thiruvananthapuram,65864,60089,u,431
04-06-2021,Kollam,42675,39359,3316,387
04-06-2021,Pathanamthitta,27393,25640,1753,106
04-06-2021,Alappuzha,45805,43389,2416,259
04-06-2021,Kottayam,38358,35945,2413,86
04-06-2021,Idukki,25442,24190,1252,42
04-06-2021,Ernakulam,64783,60682,4101,276
04-06-2021,Thrissur,123559,121621,1938,326
04-06-2021,Palakkad,89076,85547,3529,473
04-06-2021,Malappuram,59679,57036,2643,122
04-06-2021,Kozhikode,48754,45566,3188,226
04-06-2021,Wayanad,14919,13484,1435,71
04-06-2021,Kannur,23152,22116,1036,85
04-06-2021,Kasaragod,23825,23015,810,44
04-06-2021,total,693284,657679,35605,2934
05-06-2021,Thiruvananthapuram,63897,58068,5829,417
05-06-2021,Kollam,42245,39064,3181,393
05-06-2021,Pathanamthitta,27112,25426,1686,74
05-06-2021,Alappuzha,43487,41117,2370,186
05-06-2021,Kottayam,35727,33420,2307,66
05-06-2021,Idukki,25077,23772,1305,44
05-06-2021,Ernakulam,62371,58335,4036,302
05-06-2021,Thrissur,120685,118792,1893,349
05-06-2021,Palakkad,86080,82621,3459,256
05-06-2021,Malappuram,57949,55333,2616,119
05-06-2021,Kozhikode,46758,43737,3021,204
05-06-2021,Wayanad,14098,12647,1451,94
05-06-2021,Kannur,20556,19524,1032,92
05-06-2021,Kasaragod,23773,23034,739,53
05-06-2021,total,669815,634890,34925,2649
06-06-2021,Thiruvananthapuram,63680,57851,5829,410
06-06-2021,Kollam,41667,38429,3238,323
06-06-2021,Pathanamthitta,27122,25428,1694,75
06-06-2021,Alappuzha,43715,41311,2404,263
06-06-2021,Kottayam,35674,33440,2234,106
06-06-2021,Idukki,24854,23487,1367,50
06-06-2021,Ernakulam,60079,56088,3991,242
06-06-2021,Thrissur,118590,116743,1847,280
06-06-2021,Palakkad,83124,79014,4110,154
06-06-2021,Malappuram,55207,52565,2642,117
06-06-2021,Kozhikode,46124,43413,2711,198
06-06-2021,Wayanad,13535,12108,1427,62
06-06-2021,Kannur,18791,17801,990,118
06-06-2021,Kasaragod,22536,21789,747,48
06-06-2021,total,654698,619467,35231,2446
07-06-2021,Thiruvananthapuram,61756,55959,5797,459
07-06-2021,Kollam,39739,36505,3234,322
07-06-2021,Pathanamthitta,27662,26009,1653,73
07-06-2021,Alappuzha,40941,38627,2314,151
07-06-2021,Kottayam,34434,32284,2150,67
07-06-2021,Idukki,24823,23437,1386,48
07-06-2021,Ernakulam,58476,54539,3937,155
07-06-2021,Thrissur,114281,107468,6813,308
07-06-2021,Palakkad,79569,76272,3297,244
07-06-2021,Malappuram,53211,50574,2637,115
07-06-2021,Kozhikode,44155,41455,2700,192
07-06-2021,Wayanad,13195,11779,1416,30
07-06-2021,Kannur,18035,17056,979,96
07-06-2021,Kasaragod,22591,21843,748,37
07-06-2021,total,632868,593807,39061,2297
08-06-2021,Thiruvananthapuram,59376,53536,5840,672
08-06-2021,Kollam,37535,34361,3174,363
08-06-2021,Pathanamthitta,26834,25324,1510,28
08-06-2021,Alappuzha,39125,36932,2193,75
08-06-2021,Kottayam,34741,32688,2053,40
08-06-2021,Idukki,24708,23397,1311,33
08-06-2021,Ernakulam,56702,52841,3861,143
08-06-2021,Thrissur,111141,109405,1736,307
08-06-2021,Palakkad,75567,72402,3165,366
08-06-2021,Malappuram,52371,49844,2527,102
08-06-2021,Kozhikode,42171,39561,2610,195
08-06-2021,Wayanad,12281,10910,1371,62
08-06-2021,Kannur,17388,16437,951,100
08-06-2021,Kasaragod,22215,21525,690,24
08-06-2021,total,612155,579163,32992,2510
09-06-2021,Thiruvananthapuram,57812,51972,5840,574
09-06-2021,Kollam,35337,32128,3209,329
09-06-2021,Pathanamthitta,26547,24990,1557,107
09-06-2021,Alappuzha,35310,33177,2133,211
09-06-2021,Kottayam,33783,31818,1965,0
09-06-2021,Idukki,25108,23823,1285,57
09-06-2021,Ernakulam,53924,50171,3753,97
09-06-2021,Thrissur,106547,104917,1630,231
09-06-2021,Palakkad,73472,70336,3136,365
09-06-2021,Malappuram,53095,50668,2427,108
09-06-2021,Kozhikode,40748,38193,2555,235
09-06-2021,Wayanad,12291,10966,1325,64
09-06-2021,Kannur,16749,15813,936,107
09-06-2021,Kasaragod,21356,20711,645,42
09-06-2021,total,592079,559683,32396,2527
10-06-2021,Thiruvananthapuram,56168,50377,5791,449
10-06-2021,Kollam,35062,31955,3107,275
10-06-2021,Pathanamthitta,26205,24625,1580,109
10-06-2021,Alappuzha,35850,33723,2127,170
10-06-2021,Kottayam,32269,30361,1908,54
10-06-2021,Idukki,25483,24114,1369,123
10-06-2021,Ernakulam,51944,48234,3710,169
10-06-2021,Thrissur,102555,100912,1643,406
10-06-2021,Palakkad,72058,69129,2929,510
10-06-2021,Malappuram,53284,50893,2391,95
10-06-2021,Kozhikode,39967,37529,2438,186
10-06-2021,Wayanad,11946,10610,1336,87
10-06-2021,Kannur,16383,15404,979,156
10-06-2021,Kasaragod,21243,20585,658,31
10-06-2021,total,580417,548451,31966,2820
11-06-2021,Thiruvananthapuram,55210,49393,5817,448
11-06-2021,Kollam,34321,31177,3144,336
11-06-2021,Pathanamthitta,25904,24322,1582,108
11-06-2021,Alappuzha,34691,32595,2096,176
11-06-2021,Kottayam,31583,29706,1877,99
11-06-2021,Idukki,23546,22278,1268,45
11-06-2021,Ernakulam,49818,46037,3781,238
11-06-2021,Thrissur,99180,97592,1588,277
11-06-2021,Palakkad,68300,65410,2890,447
11-06-2021,Malappuram,52060,49856,2204,93
11-06-2021,Kozhikode,38066,35711,2355,201
11-06-2021,Wayanad,11691,10405,1286,53
11-06-2021,Kannur,16757,15803,954,113
11-06-2021,Kasaragod,21126,20458,668,41
11-06-2021,total,562253,530743,31510,2675
12-06-2021,Thiruvananthapuram,54193,48334,5859,380
12-06-2021,Kollam,34203,31154,3049,282
12-06-2021,Pathanamthitta,25665,24145,1520,91
12-06-2021,Alappuzha,33038,31005,2033,207
12-06-2021,Kottayam,31548,29659,1889,84
12-06-2021,Idukki,23364,22073,1291,21
12-06-2021,Ernakulam,47521,43810,3711,127
12-06-2021,Thrissur,95742,94193,1549,298
12-06-2021,Palakkad,65913,63099,2814,179
12-06-2021,Malappuram,48673,46511,2162,88
12-06-2021,Kozhikode,36822,34465,2357,191
12-06-2021,Wayanad,11275,9976,1299,72
12-06-2021,Kannur,16499,15577,922,82
12-06-2021,Kasaragod,20544,19896,648,30
12-06-2021,total,545000,513897,31103,2132
13-06-2021,Thiruvananthapuram,54870,49011,5859,384
13-06-2021,Kollam,35348,32320,3028,259
13-06-2021,Pathanamthitta,25333,23811,1522,93
13-06-2021,Alappuzha,33205,31195,2010,192
13-06-2021,Kottayam,31824,29938,1886,100
13-06-2021,Idukki,23772,22436,1336,32
13-06-2021,Ernakulam,45120,41463,3657,154
13-06-2021,Thrissur,93500,91961,1539,279
13-06-2021,Palakkad,64536,61749,2787,402
13-06-2021,Malappuram,45534,43477,2057,85
13-06-2021,Kozhikode,36875,34587,2288,172
13-06-2021,Wayanad,11078,9815,1263,45
13-06-2021,Kannur,15925,15066,859,87
13-06-2021,Kasaragod,21295,20711,584,25
13-06-2021,total,538215,507540,30675,2309
14-06-2021,Thiruvananthapuram,53444,47636,5808,302
14-06-2021,Kollam,34604,31617,2987,246
14-06-2021,Pathanamthitta,25013,23505,1508,55
14-06-2021,Alappuzha,32666,30701,1965,178
14-06-2021,Kottayam,32018,30174,1844,55
14-06-2021,Idukki,23203,21874,1329,38
14-06-2021,Ernakulam,43954,40446,3508,66
14-06-2021,Thrissur,90414,88886,1528,263
14-06-2021,Palakkad,63942,61286,2656,319
14-06-2021,Malappuram,41794,39787,2007,81
14-06-2021,Kozhikode,36331,34089,2242,143
14-06-2021,Wayanad,10970,9720,1250,40
14-06-2021,Kannur,15588,14709,879,108
14-06-2021,Kasaragod,21390,20849,541,21
14-06-2021,total,525331,495279,30052,1915
15-06-2021,Thiruvananthapuram,50778,45165,5613,583
15-06-2021,Kollam,33516,30580,2936,298
15-06-2021,Pathanamthitta,23913,22455,1458,69
15-06-2021,Alappuzha,32699,30808,1891,102
15-06-2021,Kottayam,31500,29727,1773,28
15-06-2021,Idukki,22782,21465,1317,13
15-06-2021,Ernakulam,42638,39137,3501,142
15-06-2021,Thrissur,87586,86039,1547,303
15-06-2021,Palakkad,60927,58416,2511,236
15-06-2021,Malappuram,38927,37082,1845,77
15-06-2021,Kozhikode,34575,32406,2169,165
15-06-2021,Wayanad,10673,9398,1275,61
15-06-2021,Kannur,14854,14021,833,67
15-06-2021,Kasaragod,21069,20513,556,17
15-06-2021,total,506437,477212,29225,2161
17-06-2021,Thiruvananthapuram,48659,43339,5320,510
17-06-2021,Kollam,32909,29979,2930,291
17-06-2021,Pathanamthitta,21712,20229,1483,108
17-06-2021,Alappuzha,28615,26720,1895,264
17-06-2021,Kottayam,31600,29914,1686,41
17-06-2021,Idukki,21864,20659,1205,38
17-06-2021,Ernakulam,42934,39440,3494,129
17-06-2021,Thrissur,82192,80696,1496,251
17-06-2021,Palakkad,56935,54539,2396,444
17-06-2021,Malappuram,37544,35794,1750,82
17-06-2021,Kozhikode,32991,30857,2134,172
17-06-2021,Wayanad,10248,9160,1088,45
17-06-2021,Kannur,14541,13726,815,70
17-06-2021,Kasaragod,21079,20544,535,47
17-06-2021,total,483823,455596,28227,2492
18-06-2021,Thiruvananthapuram,47650,42328,5322,457
18-06-2021,Kollam,32831,29903,2928,318
18-06-2021,Pathanamthitta,20700,19160,1540,150
18-06-2021,Alappuzha,27800,25935,1865,174
18-06-2021,Kottayam,31546,29822,1724,48
18-06-2021,Idukki,21166,19981,1185,44
18-06-2021,Ernakulam,41978,38577,3401,125
18-06-2021,Thrissur,79917,78460,1457,256
18-06-2021,Palakkad,52981,50609,2372,351
18-06-2021,Malappuram,35977,34349,1628,80
18-06-2021,Kozhikode,32031,29891,2140,159
18-06-2021,Wayanad,10085,9081,1004,43
18-06-2021,Kannur,14229,13446,783,78
18-06-2021,Kasaragod,20631,20075,556,52
18-06-2021,total,469522,441617,27905,2335
19-06-2021,Thiruvananthapuram,46616,41221,5395,350
19-06-2021,Kollam,32518,29660,2858,291
19-06-2021,Pathanamthitta,19259,17746,1513,85
19-06-2021,Alappuzha,27295,25400,1895,221
19-06-2021,Kottayam,32143,30401,1742,61
19-06-2021,Idukki,20509,19368,1141,24
19-06-2021,Ernakulam,42081,38736,3345,91
19-06-2021,Thrissur,77628,75979,1649,415
19-06-2021,Palakkad,48097,45762,2335,348
19-06-2021,Malappuram,34464,32907,1557,76
19-06-2021,Kozhikode,31178,29108,2070,125
19-06-2021,Wayanad,10216,9204,1012,49
19-06-2021,Kannur,14133,13342,791,95
19-06-2021,Kasaragod,19484,18920,564,51
19-06-2021,total,455621,427754,27867,2282
20-06-2021,Thiruvananthapuram,47309,41824,5485,499
20-06-2021,Kollam,35580,32707,2873,279
20-06-2021,Pathanamthitta,18287,16778,1509,88
20-06-2021,Alappuzha,28616,26714,1902,308
20-06-2021,Kottayam,31476,29681,1795,89
20-06-2021,Idukki,19588,18503,1085,26
20-06-2021,Ernakulam,42349,39149,3200,93
20-06-2021,Thrissur,76306,74816,1490,223
20-06-2021,Palakkad,43077,41474,1603,330
20-06-2021,Malappuram,33547,31941,1606,78
20-06-2021,Kozhikode,31524,29532,1992,105
20-06-2021,Wayanad,10122,9123,999,38
20-06-2021,Kannur,13603,12841,762,88
20-06-2021,Kasaragod,16653,16048,605,53
20-06-2021,total,448037,421131,26906,2297
21-06-2021,Thiruvananthapuram,45756,40271,5485,265
21-06-2021,Kollam,35038,32132,2906,234
21-06-2021,Pathanamthitta,16688,15170,1518,82
21-06-2021,Alappuzha,24865,23062,1803,103
21-06-2021,Kottayam,30034,28296,1738,43
21-06-2021,Idukki,18932,17944,988,36
21-06-2021,Ernakulam,42748,39545,3203,150
21-06-2021,Thrissur,74892,73354,1538,235
21-06-2021,Palakkad,39281,37167,2114,364
21-06-2021,Malappuram,31815,30201,1614,80
21-06-2021,Kozhikode,31097,29082,2015,121
21-06-2021,Wayanad,10128,9161,967,35
21-06-2021,Kannur,13596,12836,760,104
21-06-2021,Kasaragod,15858,15241,617,39
21-06-2021,total,430728,403462,27266,1891
22-06-2021,Thiruvananthapuram,44153,38751,5402,445
22-06-2021,Kollam,33199,30466,2733,297
22-06-2021,Pathanamthitta,15781,14365,1416,56
22-06-2021,Alappuzha,23657,21909,1748,106
22-06-2021,Kottayam,29511,27821,1690,32
22-06-2021,Idukki,18958,17984,974,8
22-06-2021,Ernakulam,42693,39502,3191,142
22-06-2021,Thrissur,73354,71876,1478,232
22-06-2021,Palakkad,36985,34837,2148,278
22-06-2021,Malappuram,30986,29446,1540,64
22-06-2021,Kozhikode,30216,28306,1910,121
22-06-2021,Wayanad,10069,9152,917,69
22-06-2021,Kannur,13769,13000,769,98
22-06-2021,Kasaragod,15720,15141,579,23
22-06-2021,total,419051,392556,26495,1971
23-06-2021,Thiruvananthapuram,43345,38112,5233,525
23-06-2021,Kollam,33366,30526,2840,362
23-06-2021,Pathanamthitta,14573,13068,1505,118
23-06-2021,Alappuzha,23467,21768,1699,153
23-06-2021,Kottayam,28830,27100,1730,72
23-06-2021,Idukki,19216,18336,880,29
23-06-2021,Ernakulam,41966,38832,3134,103
23-06-2021,Thrissur,71305,69854,1451,235
23-06-2021,Palakkad,35724,33500,2224,541
23-06-2021,Malappuram,31393,29854,1539,65
23-06-2021,Kozhikode,29646,27696,1950,136
23-06-2021,Wayanad,9922,9071,851,52
23-06-2021,Kannur,13753,13017,736,67
23-06-2021,Kasaragod,15610,15008,602,34
23-06-2021,total,412116,385742,26374,2492
24-06-2021,Thiruvananthapuram,42545,37358,5187,332
24-06-2021,Kollam,32836,30014,2822,364
24-06-2021,Pathanamthitta,13282,11730,1552,124
24-06-2021,Alappuzha,24309,22617,1692,161
24-06-2021,Kottayam,27705,26012,1693,80
24-06-2021,Idukki,18749,17901,848,46
24-06-2021,Ernakulam,41215,38095,3120,151
24-06-2021,Thrissur,68821,67364,1457,236
24-06-2021,Palakkad,34880,32669,2211,579
24-06-2021,Malappuram,32825,31232,1593,68
24-06-2021,Kozhikode,29792,27895,1897,136
24-06-2021,Wayanad,10056,9307,749,51
24-06-2021,Kannur,13855,13155,700,56
24-06-2021,Kasaragod,15836,15210,626,61
24-06-2021,total,406706,380559,26147,2445
25-06-2021,Thiruvananthapuram,40064,34889,5175,444
25-06-2021,Kollam,31702,28966,2736,321
25-06-2021,Pathanamthitta,12227,10649,1578,163
25-06-2021,Alappuzha,22070,20380,1690,175
25-06-2021,Kottayam,25971,24291,1680,102
25-06-2021,Idukki,18522,17749,773,23
25-06-2021,Ernakulam,41652,38560,3092,134
25-06-2021,Thrissur,65510,64064,1446,235
25-06-2021,Palakkad,35629,33442,2187,358
25-06-2021,Malappuram,29806,28205,1601,69
25-06-2021,Kozhikode,28383,26440,1943,155
25-06-2021,Wayanad,10320,9569,751,79
25-06-2021,Kannur,13534,12845,689,80
25-06-2021,Kasaragod,17243,16601,642,50
25-06-2021,total,392633,366650,25983,2388
26-06-2021,Thiruvananthapuram,40193,35018,5175,278
26-06-2021,Kollam,32303,29568,2735,304
26-06-2021,Pathanamthitta,10849,9318,1531,84
26-06-2021,Alappuzha,22412,20818,1594,145
26-06-2021,Kottayam,25907,24207,1700,52
26-06-2021,Idukki,18237,17472,765,23
26-06-2021,Ernakulam,41581,38570,3011,76
26-06-2021,Thrissur,65141,63677,1464,241
26-06-2021,Palakkad,36664,34102,2562,315
26-06-2021,Malappuram,30884,29266,1618,68
26-06-2021,Kozhikode,29527,27572,1955,143
26-06-2021,Wayanad,10757,9987,770,63
26-06-2021,Kannur,13365,12628,737,94
26-06-2021,Kasaragod,19043,18362,681,57
26-06-2021,total,396863,370565,26298,1943
27-06-2021,Thiruvananthapuram,40570,35474,5096,233
27-06-2021,Kollam,33020,30242,2778,264
27-06-2021,Pathanamthitta,10616,9066,1550,94
27-06-2021,Alappuzha,23510,21939,1571,164
27-06-2021,Kottayam,25747,24079,1668,52
27-06-2021,Idukki,17373,16657,716,53
27-06-2021,Ernakulam,40971,38068,2903,87
27-06-2021,Thrissur,63947,62470,1477,232
27-06-2021,Palakkad,35901,33720,2181,272
27-06-2021,Malappuram,30766,29213,1553,64
27-06-2021,Kozhikode,30289,28377,1912,171
27-06-2021,Wayanad,10813,10048,765,51
27-06-2021,Kannur,13721,12934,787,117
27-06-2021,Kasaragod,19849,19116,733,56
27-06-2021,total,397093,371403,25690,1910
28-06-2021,Thiruvananthapuram,39604,34581,5023,262
28-06-2021,Kollam,32317,29557,2760,240
28-06-2021,Pathanamthitta,10583,8959,1624,102
28-06-2021,Alappuzha,22355,20817,1538,162
28-06-2021,Kottayam,24827,23196,1631,50
28-06-2021,Idukki,16961,16299,662,23
28-06-2021,Ernakulam,40853,37958,2895,97
28-06-2021,Thrissur,62906,61427,1479,228
28-06-2021,Palakkad,35199,32995,2204,339
28-06-2021,Malappuram,30328,28719,1609,66
28-06-2021,Kozhikode,29807,27858,1949,167
28-06-2021,Wayanad,10814,10003,811,90
28-06-2021,Kannur,13158,12380,778,60
28-06-2021,Kasaragod,20518,19794,724,50
28-06-2021,total,390230,364543,25687,1936
29-06-2021,Thiruvananthapuram,38932,33929,5003,381
29-06-2021,Kollam,31474,28728,2746,365
29-06-2021,Pathanamthitta,10187,8679,1508,42
29-06-2021,Alappuzha,22533,21012,1521,81
29-06-2021,Kottayam,24216,22627,1589,21
29-06-2021,Idukki,16636,16000,636,19
29-06-2021,Ernakulam,40281,37370,2911,147
29-06-2021,Thrissur,62579,61123,1456,247
29-06-2021,Palakkad,34894,32809,2085,277
29-06-2021,Malappuram,30856,29323,1533,62
29-06-2021,Kozhikode,30667,28771,1896,129
29-06-2021,Wayanad,10789,9945,844,80
29-06-2021,Kannur,13270,12489,781,93
29-06-2021,Kasaragod,20769,20097,672,35
29-06-2021,total,388083,362902,25181,1979
30-06-2021,Thiruvananthapuram,37945,33051,4894,313
30-06-2021,Kollam,31649,28911,2738,342
30-06-2021,Pathanamthitta,10053,8500,1553,131
30-06-2021,Alappuzha,22365,20906,1459,114
30-06-2021,Kottayam,24295,22732,1563,96
30-06-2021,Idukki,15890,15278,612,28
30-06-2021,Ernakulam,40073,37202,2871,102
30-06-2021,Thrissur,62557,61129,1428,207
30-06-2021,Palakkad,35011,32959,2052,456
30-06-2021,Malappuram,32663,31173,1490,68
30-06-2021,Kozhikode,30985,29168,1817,168
30-06-2021,Wayanad,10936,10078,858,69
30-06-2021,Kannur,13097,12347,750,81
30-06-2021,Kasaragod,21384,20666,718,59
30-06-2021,total,388903,364100,24803,2234
01-07-2021,Thiruvananthapuram,37663,32769,4894,312
01-07-2021,Kollam,31613,28908,2705,263
01-07-2021,Pathanamthitta,10286,8731,1555,102
01-07-2021,Alappuzha,21831,20302,1529,155
01-07-2021,Kottayam,24740,23130,1610,87
01-07-2021,Idukki,15905,15308,597,18
01-07-2021,Ernakulam,39727,36964,2763,68
01-07-2021,Thrissur,62053,60665,1388,250
01-07-2021,Palakkad,35137,33047,2090,343
01-07-2021,Malappuram,33957,32398,1559,72
01-07-2021,Kozhikode,31811,30010,1801,180
01-07-2021,Wayanad,11043,10096,947,139
01-07-2021,Kannur,13264,12496,768,122
01-07-2021,Kasaragod,22202,21459,743,52
01-07-2021,total,391232,366283,24949,2163
03-07-2021,Thiruvananthapuram,36107,31330,4777,289
03-07-2021,Kollam,29941,27326,2615,311
03-07-2021,Pathanamthitta,9782,8324,1458,80
03-07-2021,Alappuzha,21940,20390,1550,209
03-07-2021,Kottayam,24153,22594,1559,85
03-07-2021,Idukki,15675,15049,626,19
03-07-2021,Ernakulam,39253,36517,2736,152
03-07-2021,Thrissur,61201,59847,1354,248
03-07-2021,Palakkad,36102,34078,2024,401
03-07-2021,Malappuram,33473,32055,1418,67
03-07-2021,Kozhikode,32224,30456,1768,193
03-07-2021,Wayanad,11514,10537,977,104
03-07-2021,Kannur,15348,14598,750,81
03-07-2021,Kasaragod,24259,23434,825,43
03-07-2021,total,390972,366535,24437,2282
04-07-2021,Thiruvananthapuram,36523,31839,4684,288
04-07-2021,Kollam,31339,28695,2644,319
04-07-2021,Pathanamthitta,9936,8492,1444,104
04-07-2021,Alappuzha,23092,21500,1592,166
04-07-2021,Kottayam,24386,22757,1629,67
04-07-2021,Idukki,15550,14920,630,12
04-07-2021,Ernakulam,39123,36383,2740,131
04-07-2021,Thrissur,58904,57611,1293,227
04-07-2021,Palakkad,36321,34277,2044,310
04-07-2021,Malappuram,35936,34499,1437,68
04-07-2021,Kozhikode,33246,31470,1776,127
04-07-2021,Wayanad,11554,10528,1026,78
04-07-2021,Kannur,16243,15479,764,75
04-07-2021,Kasaragod,24673,23829,844,46
04-07-2021,total,396826,372279,24547,2018
05-07-2021,Thiruvananthapuram,35222,30538,4684,201
05-07-2021,Kollam,30512,27902,2610,205
05-07-2021,Pathanamthitta,10037,8661,1376,52
05-07-2021,Alappuzha,24790,23189,1601,152
05-07-2021,Kottayam,24207,22542,1665,81
05-07-2021,Idukki,14986,14366,620,35
05-07-2021,Ernakulam,38902,36225,2677,81
05-07-2021,Thrissur,55481,54188,1293,233
05-07-2021,Palakkad,35343,33228,2115,390
05-07-2021,Malappuram,37779,36355,1424,67
05-07-2021,Kozhikode,33479,31626,1853,198
05-07-2021,Wayanad,11652,10634,1018,28
05-07-2021,Kannur,17370,16590,780,88
05-07-2021,Kasaragod,24867,24011,856,58
05-07-2021,total,394627,370055,24572,1869
06-07-2021,Thiruvananthapuram,33641,29073,4568,257
06-07-2021,Kollam,31696,29164,2532,289
06-07-2021,Pathanamthitta,10177,8886,1291,42
06-07-2021,Alappuzha,24248,22629,1619,128
06-07-2021,Kottayam,23566,21899,1667,45
06-07-2021,Idukki,14611,14014,597,20
06-07-2021,Ernakulam,38311,35591,2720,175
06-07-2021,Thrissur,51598,50330,1268,284
06-07-2021,Palakkad,33700,31601,2099,272
06-07-2021,Malappuram,35841,34422,1419,66
06-07-2021,Kozhikode,33165,31254,1911,153
06-07-2021,Wayanad,11385,10434,951,49
06-07-2021,Kannur,17664,16876,788,99
06-07-2021,Kasaragod,24836,24127,709,29
06-07-2021,total,384439,360300,24139,1908
07-07-2021,Thiruvananthapuram,34122,29709,4413,287
07-07-2021,Kollam,29724,27234,2490,294
07-07-2021,Pathanamthitta,10255,8986,1269,80
07-07-2021,Alappuzha,23954,22245,1709,224
07-07-2021,Kottayam,23238,21510,1728,105
07-07-2021,Idukki,14283,13681,602,32
07-07-2021,Ernakulam,38341,35647,2694,112
07-07-2021,Thrissur,48865,47591,1274,249
07-07-2021,Palakkad,32173,30075,2098,369
07-07-2021,Malappuram,39236,37765,1471,69
07-07-2021,Kozhikode,34811,32741,2070,178
07-07-2021,Wayanad,11811,10850,961,59
07-07-2021,Kannur,16159,15371,788,118
07-07-2021,Kasaragod,25871,25160,711,42
07-07-2021,total,382843,358565,24278,2218
08-07-2021,Thiruvananthapuram,34784,30374,4410,315
08-07-2021,Kollam,32681,30183,2498,316
08-07-2021,Pathanamthitta,10082,8797,1285,93
08-07-2021,Alappuzha,25201,23441,1760,182
08-07-2021,Kottayam,22807,21016,1791,107
08-07-2021,Idukki,13913,13307,606,32
08-07-2021,Ernakulam,38293,35591,2702,145
08-07-2021,Thrissur,45441,44183,1258,259
08-07-2021,Palakkad,33699,31712,1987,458
08-07-2021,Malappuram,40926,39459,1467,68
08-07-2021,Kozhikode,36698,34617,2081,193
08-07-2021,Wayanad,12247,11138,1109,216
08-07-2021,Kannur,17135,16346,789,87
08-07-2021,Kasaragod,27537,26771,766,63
08-07-2021,total,391444,366935,24509,2534
09-07-2021,Thiruvananthapuram,34032,29666,4366,250
09-07-2021,Kollam,32530,30005,2525,289
09-07-2021,Pathanamthitta,9952,8719,1233,81
09-07-2021,Alappuzha,25092,23256,1836,206
09-07-2021,Kottayam,22167,20326,1841,99
09-07-2021,Idukki,13438,12820,618,54
09-07-2021,Ernakulam,37978,35305,2673,93
09-07-2021,Thrissur,40438,39175,1263,261
09-07-2021,Palakkad,33939,31978,1961,387
09-07-2021,Malappuram,42638,41168,1470,67
09-07-2021,Kozhikode,36758,34606,2152,176
09-07-2021,Wayanad,12856,11710,1146,83
09-07-2021,Kannur,17731,16918,813,104
09-07-2021,Kasaragod,27947,27269,678,50
09-07-2021,total,387496,362921,24575,2200
10-07-2021,Thiruvananthapuram,33442,29059,4383,203
10-07-2021,Kollam,32877,30365,2512,312
10-07-2021,Pathanamthitta,10041,8839,1202,83
10-07-2021,Alappuzha,25385,23547,1838,218
10-07-2021,Kottayam,22106,20317,1789,108
10-07-2021,Idukki,12548,11916,632,46
10-07-2021,Ernakulam,37878,35166,2712,145
10-07-2021,Thrissur,36315,35053,1262,247
10-07-2021,Palakkad,33378,31416,1962,287
10-07-2021,Malappuram,43991,42428,1563,71
10-07-2021,Kozhikode,37490,35286,2204,238
10-07-2021,Wayanad,12840,11661,1179,93
10-07-2021,Kannur,18111,17299,812,92
10-07-2021,Kasaragod,28091,27362,729,61
10-07-2021,total,384493,359714,24779,2204
11-07-2021,Thiruvananthapuram,34137,29740,4397,247
11-07-2021,Kollam,33426,30944,2482,223
11-07-2021,Pathanamthitta,9878,8682,1196,79
11-07-2021,Alappuzha,26677,24798,1879,304
11-07-2021,Kottayam,22469,20590,1879,116
11-07-2021,Idukki,12158,11496,662,31
11-07-2021,Ernakulam,37764,35069,2695,146
11-07-2021,Thrissur,32101,30834,1267,270
11-07-2021,Palakkad,34729,32800,1929,414
11-07-2021,Malappuram,46229,44659,1570,69
11-07-2021,Kozhikode,38239,36055,2184,187
11-07-2021,Wayanad,13054,11925,1129,43
11-07-2021,Kannur,17675,16844,831,90
11-07-2021,Kasaragod,28340,27586,754,60
11-07-2021,total,386876,362022,24854,2279
12-07-2021,Thiruvananthapuram,32942,28545,4397,178
12-07-2021,Kollam,32222,29787,2435,244
12-07-2021,Pathanamthitta,9601,8428,1173,38
12-07-2021,Alappuzha,25313,23398,1915,166
12-07-2021,Kottayam,22411,20497,1914,66
12-07-2021,Idukki,11562,10877,685,37
12-07-2021,Ernakulam,37617,34913,2704,100
12-07-2021,Thrissur,31315,29989,1326,263
12-07-2021,Palakkad,33764,31913,1851,329
12-07-2021,Malappuram,46624,45062,1562,67
12-07-2021,Kozhikode,38386,36288,2098,170
12-07-2021,Wayanad,13309,12195,1114,68
12-07-2021,Kannur,18061,17251,810,82
12-07-2021,Kasaragod,28546,27745,801,54
12-07-2021,total,381673,356888,24785,1862
13-07-2021,Thiruvananthapuram,32694,28335,4359,271
13-07-2021,Kollam,31152,28765,2387,280
13-07-2021,Pathanamthitta,9400,8276,1124,53
13-07-2021,Alappuzha,25260,23411,1849,72
13-07-2021,Kottayam,22714,20801,1913,55
13-07-2021,Idukki,11052,10363,689,17
13-07-2021,Ernakulam,37032,34316,2716,134
13-07-2021,Thrissur,32716,31412,1304,229
13-07-2021,Palakkad,33475,31701,1774,244
13-07-2021,Malappuram,47722,46158,1564,63
13-07-2021,Kozhikode,38281,36198,2083,174
13-07-2021,Wayanad,13525,12407,1118,62
13-07-2021,Kannur,18760,17960,800,88
13-07-2021,Kasaragod,28477,27648,829,43
13-07-2021,total,382260,357751,24509,1785
14-07-2021,Thiruvananthapuram,32480,28149,4331,243
14-07-2021,Kollam,31373,28933,2440,313
14-07-2021,Pathanamthitta,9670,8454,1216,91
14-07-2021,Alappuzha,26224,24390,1834,197
14-07-2021,Kottayam,24000,22099,1901,136
14-07-2021,Idukki,10910,10260,650,28
14-07-2021,Ernakulam,37913,35194,2719,134
14-07-2021,Thrissur,34060,32721,1339,249
14-07-2021,Palakkad,34567,32793,1774,435
14-07-2021,Malappuram,49623,48019,1604,76
14-07-2021,Kozhikode,39692,37707,1985,191
14-07-2021,Wayanad,13565,12380,1185,127
14-07-2021,Kannur,,,,
14-07-2021,Kasaragod,,,,
14-07-2021,total,,,,
15-07-2021,Thiruvananthapuram,32125,27863,4262,166
15-07-2021,Kollam,31538,29061,2477,295
15-07-2021,Pathanamthitta,9356,8086,1270,106
15-07-2021,Alappuzha,26574,24637,1937,263
15-07-2021,Kottayam,24077,22175,1902,94
15-07-2021,Idukki,10866,10184,682,37
15-07-2021,Ernakulam,38561,35678,2883,224
15-07-2021,Thrissur,35145,33786,1359,290
15-07-2021,Palakkad,33425,31696,1729,412
15-07-2021,Malappuram,50819,49190,1629,79
15-07-2021,Kozhikode,40705,38739,1966,206
15-07-2021,Wayanad,13443,12264,1179,88
15-07-2021,Kannur,,,,
15-07-2021,Kasaragod,,,,
15-07-2021,total,,,,
16-07-2021,Thiruvananthapuram,32195,27974,4221,202
16-07-2021,Kollam,31427,28951,2476,288
16-07-2021,Pathanamthitta,9187,7905,1282,132
16-07-2021,Alappuzha,27087,25247,1840,142
16-07-2021,Kottayam,24433,22527,1906,88
16-07-2021,Idukki,10891,10215,676,32
16-07-2021,Ernakulam,39783,36776,3007,202
16-07-2021,Thrissur,36627,35319,1308,240
16-07-2021,Palakkad,31638,29965,1673,384
16-07-2021,Malappuram,51808,50169,1639,81
16-07-2021,Kozhikode,41566,39599,1967,227
16-07-2021,Wayanad,13500,12296,1204,86
16-07-2021,Kannur,18524,17719,805,105
16-07-2021,Kasaragod,28498,27655,843,45
16-07-2021,total,397164,372317,24847,2254
18-07-2021,Thiruvananthapuram,32260,28039,4221,189
18-07-2021,Kollam,30191,27794,2397,181
18-07-2021,Pathanamthitta,9015,7735,1280,74
18-07-2021,Alappuzha,29264,27337,1927,190
18-07-2021,Kottayam,26927,24979,1948,117
18-07-2021,Idukki,10917,10286,631,12
18-07-2021,Ernakulam,40103,37064,3039,104
18-07-2021,Thrissur,32956,31669,1287,292
18-07-2021,Palakkad,31890,30239,1651,325
18-07-2021,Malappuram,53405,51698,1707,88
18-07-2021,Kozhikode,44141,42189,1952,197
18-07-2021,Wayanad,13749,12630,1119,91
18-07-2021,Kannur,21075,20287,788,80
18-07-2021,Kasaragod,29283,28436,847,65
18-07-2021,total,405176,380382,24794,2005
19-07-2021,Thiruvananthapuram,32315,28094,4221,190
19-07-2021,Kollam,29589,27177,2412,320
19-07-2021,Pathanamthitta,8890,7575,1315,45
19-07-2021,Alappuzha,27478,25561,1917,224
19-07-2021,Kottayam,27139,25164,1975,113
19-07-2021,Idukki,10864,10218,646,17
19-07-2021,Ernakulam,41114,38209,2905,77
19-07-2021,Thrissur,33693,32378,1315,282
19-07-2021,Palakkad,32932,31331,1601,382
19-07-2021,Malappuram,52728,51070,1658,81
19-07-2021,Kozhikode,44774,42862,1912,170
19-07-2021,Wayanad,14007,12856,1151,83
19-07-2021,Kannur,22083,21294,789,90
19-07-2021,Kasaragod,29198,28292,906,63
19-07-2021,total,406804,382081,24723,2137
20-07-2021,Thiruvananthapuram,32069,27887,4182,207
20-07-2021,Kollam,28842,26437,2405,327
20-07-2021,Pathanamthitta,9090,7812,1278,56
20-07-2021,Alappuzha,28784,26916,1868,115
20-07-2021,Kottayam,27311,25349,1962,92
20-07-2021,Idukki,6634,5978,656,18
20-07-2021,Ernakulam,41243,38190,3053,210
20-07-2021,Thrissur,32354,31055,1299,272
20-07-2021,Palakkad,32836,31231,1605,328
20-07-2021,Malappuram,53419,51779,1640,77
20-07-2021,Kozhikode,45235,43281,1954,151
20-07-2021,Wayanad,14081,12928,1153,71
20-07-2021,Kannur,22696,21918,778,78
20-07-2021,Kasaragod,30584,29665,919,47
20-07-2021,total,405178,380426,24752,2049
22-07-2021,Thiruvananthapuram,31149,26959,4190,293
22-07-2021,Kollam,27718,25311,2407,222
22-07-2021,Pathanamthitta,10007,8615,1392,102
22-07-2021,Alappuzha,27584,25649,1935,329
22-07-2021,Kottayam,29956,27797,2159,141
22-07-2021,Idukki,6472,5801,671,44
22-07-2021,Ernakulam,42990,39882,3108,119
22-07-2021,Thrissur,33640,32377,1263,279
22-07-2021,Palakkad,33348,31708,1640,492
22-07-2021,Malappuram,55379,53718,1661,60
22-07-2021,Kozhikode,44313,42188,2125,243
22-07-2021,Wayanad,13971,12797,1174,69
22-07-2021,Kannur,23756,22991,765,78
22-07-2021,Kasaragod,29040,28033,1007,66
22-07-2021,total,409323,383826,25497,2537
23-07-2021,Thiruvananthapuram,31069,26855,4214,224
23-07-2021,Kollam,29646,27213,2433,328
23-07-2021,Pathanamthitta,9977,8612,1365,93
23-07-2021,Alappuzha,27593,25689,1904,126
23-07-2021,Kottayam,30847,28658,2189,116
23-07-2021,Idukki,6478,5921,557,19
23-07-2021,Ernakulam,43865,40712,3153,147
23-07-2021,Thrissur,34558,33280,1278,285
23-07-2021,Palakkad,35383,33645,1738,402
23-07-2021,Malappuram,57155,55416,1739,67
23-07-2021,Kozhikode,44565,42441,2124,202
23-07-2021,Wayanad,13877,12654,1223,103
23-07-2021,Kannur,23973,23211,762,74
23-07-2021,Kasaragod,29510,28498,1012,55
23-07-2021,total,418496,392805,25691,2241
24-07-2021,Thiruvananthapuram,30390,26224,4166,181
24-07-2021,Kollam,29699,27261,2438,257
24-07-2021,Pathanamthitta,10301,8881,1420,94
24-07-2021,Alappuzha,27547,25693,1854,183
24-07-2021,Kottayam,31470,29191,2279,158
24-07-2021,Idukki,6595,6036,559,18
24-07-2021,Ernakulam,44618,41402,3216,141
24-07-2021,Thrissur,34734,33343,1391,349
24-07-2021,Palakkad,37297,35527,1770,326
24-07-2021,Malappuram,59100,57396,1704,66
24-07-2021,Kozhikode,44538,42417,2121,229
24-07-2021,Wayanad,13601,12402,1199,78
24-07-2021,Kannur,24638,23864,774,83
24-07-2021,Kasaragod,29823,28770,1053,44
24-07-2021,total,424351,398407,25944,2207
25-07-2021,Thiruvananthapuram,31179,27013,4166,236
25-07-2021,Kollam,31282,28836,2446,295
25-07-2021,Pathanamthitta,10945,9501,1444,98
25-07-2021,Alappuzha,28339,26446,1893,202
25-07-2021,Kottayam,31787,29501,2286,116
25-07-2021,Idukki,6860,6316,544,10
25-07-2021,Ernakulam,45932,42685,3247,120
25-07-2021,Thrissur,35117,33625,1492,321
25-07-2021,Palakkad,37635,35865,1770,542
25-07-2021,Malappuram,62940,61245,1695,65
25-07-2021,Kozhikode,46369,44165,2204,191
25-07-2021,Wayanad,13443,12275,1168,58
25-07-2021,Kannur,24752,23964,788,108
25-07-2021,Kasaragod,29188,28103,1085,35
25-07-2021,total,435768,409540,26228,2397
26-07-2021,Thiruvananthapuram,30634,26501,4133,184
26-07-2021,Kollam,30694,28295,2399,280
26-07-2021,Pathanamthitta,11190,9712,1478,103
26-07-2021,Alappuzha,26842,25028,1814,172
26-07-2021,Kottayam,31863,29615,2248,88
26-07-2021,Idukki,7013,6496,517,9
26-07-2021,Ernakulam,47052,43888,3164,70
26-07-2021,Thrissur,33860,32351,1509,268
26-07-2021,Palakkad,39605,37597,2008,558
26-07-2021,Malappuram,61261,59601,1660,62
26-07-2021,Kozhikode,46233,44026,2207,224
26-07-2021,Wayanad,13440,12290,1150,58
26-07-2021,Kannur,25181,24367,814,86
26-07-2021,Kasaragod,28347,27335,1012,57
26-07-2021,total,433215,407102,26113,2219
27-07-2021,Thiruvananthapuram,30471,26405,4066,371
27-07-2021,Kollam,30143,27660,2483,309
27-07-2021,Pathanamthitta,11330,9897,1433,61
27-07-2021,Alappuzha,28461,26517,1944,200
27-07-2021,Kottayam,32286,30030,2256,64
27-07-2021,Idukki,7221,6680,541,24
27-07-2021,Ernakulam,46662,43429,3233,189
27-07-2021,Thrissur,34893,33389,1504,272
27-07-2021,Palakkad,40364,38353,2011,334
27-07-2021,Malappuram,61086,59424,1662,63
27-07-2021,Kozhikode,46503,44163,2340,205
27-07-2021,Wayanad,13275,12078,1197,108
27-07-2021,Kannur,25541,24709,832,87
27-07-2021,Kasaragod,28151,27197,954,64
27-07-2021,total,436387,409931,26456,2351
28-07-2021,Thiruvananthapuram,30873,26788,4085,241
28-07-2021,Kollam,31652,29090,2562,378
28-07-2021,Pathanamthitta,11353,9876,1477,128
28-07-2021,Alappuzha,27649,25667,1982,176
28-07-2021,Kottayam,33883,31667,2216,165
28-07-2021,Idukki,7324,6823,501,29
28-07-2021,Ernakulam,45765,42521,3244,148
28-07-2021,Thrissur,38012,36416,1596,352
28-07-2021,Palakkad,40795,38666,2129,704
28-07-2021,Malappuram,63057,61332,1725,288
28-07-2021,Kozhikode,47515,45039,2476,226
28-07-2021,Wayanad,13556,12302,1254,109
28-07-2021,Kannur,26368,25511,857,109
28-07-2021,Kasaragod,28409,27400,1009,72
28-07-2021,total,446211,419098,27113,3125
29-07-2021,Thiruvananthapuram,32771,28686,4085,272
29-07-2021,Kollam,33219,30687,2532,302
29-07-2021,Pathanamthitta,11784,10262,1522,137
29-07-2021,Alappuzha,26931,24951,1980,177
29-07-2021,Kottayam,34623,32366,2257,136
29-07-2021,Idukki,7347,6858,489,29
29-07-2021,Ernakulam,45586,42276,3310,126
29-07-2021,Thrissur,40451,38817,1634,346
29-07-2021,Palakkad,40166,37879,2287,484
29-07-2021,Malappuram,62779,61007,1772,294
29-07-2021,Kozhikode,48820,46335,2485,256
29-07-2021,Wayanad,14330,13089,1241,72
29-07-2021,Kannur,27348,26509,839,82
29-07-2021,Kasaragod,27925,26878,1047,96
29-07-2021,total,454080,426600,27480,2809
30-07-2021,Thiruvananthapuram,32828,28778,4050,169
30-07-2021,Kollam,31656,29123,2533,265
30-07-2021,Pathanamthitta,11940,10405,1535,100
30-07-2021,Alappuzha,25755,23669,2086,219
30-07-2021,Kottayam,34930,32641,2289,147
30-07-2021,Idukki,7485,7000,485,26
30-07-2021,Ernakulam,46474,43157,3317,114
30-07-2021,Thrissur,39995,38384,1611,357
30-07-2021,Palakkad,40513,38129,2384,633
30-07-2021,Malappuram,65696,63900,1796,302
30-07-2021,Kozhikode,49879,47326,2553,206
30-07-2021,Wayanad,14951,13665,1286,114
30-07-2021,Kannur,26734,25904,830,89
30-07-2021,Kasaragod,28115,27037,1078,63
30-07-2021,total,456951,429118,27833,2804
31-07-2021,Thiruvananthapuram,31820,27784,4036,189
31-07-2021,Kollam,31814,29173,2641,330
31-07-2021,Pathanamthitta,12285,10700,1585,105
31-07-2021,Alappuzha,24316,22136,2180,150
31-07-2021,Kottayam,35716,33348,2368,125
31-07-2021,Idukki,7526,7031,495,21
31-07-2021,Ernakulam,46607,43214,3393,161
31-07-2021,Thrissur,41584,39962,1622,341
31-07-2021,Palakkad,40240,37778,2462,639
31-07-2021,Malappuram,62239,60392,1847,313
31-07-2021,Kozhikode,50181,47664,2517,253
31-07-2021,Wayanad,15185,13756,1429,205
31-07-2021,Kannur,27165,26356,809,70
31-07-2021,Kasaragod,28400,27346,1054,43
31-07-2021,total,455078,426640,28438,2945
01-08-2021,Thiruvananthapuram,32283,28248,4035,183
01-08-2021,Kollam,32837,30234,2603,270
01-08-2021,Pathanamthitta,12589,10952,1637,122
01-08-2021,Alappuzha,24662,22501,2161,153
01-08-2021,Kottayam,36933,34568,2365,126
01-08-2021,Idukki,7562,7070,492,12
01-08-2021,Ernakulam,46418,42916,3502,160
01-08-2021,Thrissur,42754,41091,1663,343
01-08-2021,Palakkad,39775,37279,2496,255
01-08-2021,Malappuram,64234,62367,1867,315
01-08-2021,Kozhikode,51721,49161,2560,252
01-08-2021,Wayanad,14510,13091,1419,73
01-08-2021,Kannur,26977,26170,807,72
01-08-2021,Kasaragod,27878,26889,989,66
01-08-2021,total,461133,432537,28596,2402
02-08-2021,Thiruvananthapuram,32068,28033,4035,203
02-08-2021,Kollam,32135,29522,2613,259
02-08-2021,Pathanamthitta,12135,10538,1597,75
02-08-2021,Alappuzha,24531,22432,2099,97
02-08-2021,Kottayam,37478,35179,2299,116
02-08-2021,Idukki,7682,7144,538,11
02-08-2021,Ernakulam,45755,42243,3512,96
02-08-2021,Thrissur,44346,42649,1697,295
02-08-2021,Palakkad,39831,37242,2589,669
02-08-2021,Malappuram,64291,62363,1928,322
02-08-2021,Kozhikode,52038,49519,2519,202
02-08-2021,Wayanad,15585,14157,1428,67
02-08-2021,Kannur,27564,26736,828,103
02-08-2021,Kasaragod,27090,26122,968,35
02-08-2021,total,462529,433879,28650,2550
04-08-2021,Thiruvananthapuram,32169,28233,3936,233
04-08-2021,Kollam,32497,29790,2707,349
04-08-2021,Pathanamthitta,11940,10330,1610,144
04-08-2021,Alappuzha,22663,20467,2196,283
04-08-2021,Kottayam,39112,36673,2439,187
04-08-2021,Idukki,7470,6913,557,32
04-08-2021,Ernakulam,45317,41677,3640,137
04-08-2021,Thrissur,48119,46383,1736,377
04-08-2021,Palakkad,38687,35184,3503,295
04-08-2021,Malappuram,69648,67726,1922,314
04-08-2021,Kozhikode,54344,51788,2556,249
04-08-2021,Wayanad,16357,14902,1455,85
04-08-2021,Kannur,28337,27506,831,94
04-08-2021,Kasaragod,27396,26437,959,57
04-08-2021,total,474056,444009,30047,2836
06-08-2021,Thiruvananthapuram,32706,28866,3840,287
06-08-2021,Kollam,32969,30344,2625,239
06-08-2021,Pathanamthitta,11484,9848,1636,75
06-08-2021,Alappuzha,22012,19781,2231,210
06-08-2021,Kottayam,40632,38224,2408,134
06-08-2021,Idukki,7834,7223,611,49
06-08-2021,Ernakulam,44648,41171,3477,85
06-08-2021,Thrissur,50863,49096,1767,354
06-08-2021,Palakkad,37852,35108,2744,156
06-08-2021,Malappuram,73332,71343,1989,322
06-08-2021,Kozhikode,57748,55277,2471,163
06-08-2021,Wayanad,17751,16248,1503,116
06-08-2021,Kannur,29214,28365,849,77
06-08-2021,Kasaragod,28447,27503,944,59
06-08-2021,total,487492,458397,29095,2326
08-08-2021,Thiruvananthapuram,33408,29507,3901,156
08-08-2021,Kollam,34466,31914,2552,220
08-08-2021,Pathanamthitta,11073,9399,1674,114
08-08-2021,Alappuzha,21530,19286,2244,305
08-08-2021,Kottayam,39488,37155,2333,148
08-08-2021,Idukki,8290,7684,606,11
08-08-2021,Ernakulam,43158,39676,3482,74
08-08-2021,Thrissur,52187,50432,1755,300
08-08-2021,Palakkad,35682,32862,2820,237
08-08-2021,Malappuram,74517,72543,1974,311
08-08-2021,Kozhikode,59174,56550,2624,211
08-08-2021,Wayanad,18458,16909,1549,113
08-08-2021,Kannur,29661,28807,854,76
08-08-2021,Kasaragod,29766,28806,960,52
08-08-2021,total,490858,461530,29328,2328
09-08-2021,Thiruvananthapuram,33184,28953,4231,206
09-08-2021,Kollam,33271,30738,2533,250
09-08-2021,Pathanamthitta,11183,9576,1607,97
09-08-2021,Alappuzha,20425,18205,2220,118
09-08-2021,Kottayam,40356,38106,2250,73
09-08-2021,Idukki,8547,7918,629,17
09-08-2021,Ernakulam,42744,39269,3475,95
09-08-2021,Thrissur,52548,50772,1776,279
09-08-2021,Palakkad,36581,33764,2817,253
09-08-2021,Malappuram,71523,69571,1952,304
09-08-2021,Kozhikode,58688,56165,2523,221
09-08-2021,Wayanad,18444,16921,1523,76
09-08-2021,Kannur,30039,29143,896,93
09-08-2021,Kasaragod,29303,28393,910,43
09-08-2021,total,486836,457494,29342,2125
10-08-2021,Thiruvananthapuram,33016,29115,3901,212
10-08-2021,Kollam,31684,29183,2501,347
10-08-2021,Pathanamthitta,11280,9723,1557,56
10-08-2021,Alappuzha,20765,18520,2245,137
10-08-2021,Kottayam,40594,38300,2294,66
10-08-2021,Idukki,8524,7899,625,19
10-08-2021,Ernakulam,43002,39504,3498,167
10-08-2021,Thrissur,52750,51000,1750,321
10-08-2021,Palakkad,36905,34088,2817,127
10-08-2021,Malappuram,67148,65269,1879,283
10-08-2021,Kozhikode,59235,56762,2473,167
10-08-2021,Wayanad,18337,16878,1459,70
10-08-2021,Kannur,30640,29753,887,82
10-08-2021,Kasaragod,28410,27546,864,47
10-08-2021,total,482290,453540,28750,2101
12-08-2021,Thiruvananthapuram,33473,29599,3874,251
12-08-2021,Kollam,30663,28205,2458,287
12-08-2021,Pathanamthitta,10925,9323,1602,129
12-08-2021,Alappuzha,21051,18722,2329,273
12-08-2021,Kottayam,41218,38937,2281,91
12-08-2021,Idukki,8674,8004,670,31
12-08-2021,Ernakulam,42522,39228,3294,92
12-08-2021,Thrissur,54337,52652,1685,346
12-08-2021,Palakkad,35336,32547,2789,314
12-08-2021,Malappuram,69460,67651,1809,265
12-08-2021,Kozhikode,60540,58106,2434,268
12-08-2021,Wayanad,18718,17205,1513,95
12-08-2021,Kannur,30546,29694,852,77
12-08-2021,Kasaragod,25709,24816,893,40
12-08-2021,total,483172,454689,28483,2559
13-08-2021,Thiruvananthapuram,33948,30060,3888,233
13-08-2021,Kollam,30288,27913,2375,217
13-08-2021,Pathanamthitta,10773,9187,1586,83
13-08-2021,Alappuzha,20972,18664,2308,192
13-08-2021,Kottayam,41933,39632,2301,127
13-08-2021,Idukki,8940,8286,654,19
13-08-2021,Ernakulam,42320,38963,3357,199
13-08-2021,Thrissur,55668,54023,1645,281
13-08-2021,Palakkad,34878,32082,2796,338
13-08-2021,Malappuram,73701,71882,1819,268
13-08-2021,Kozhikode,61934,59463,2471,195
13-08-2021,Wayanad,18974,17513,1461,74
13-08-2021,Kannur,31013,30154,859,96
13-08-2021,Kasaragod,25494,24594,900,42
13-08-2021,total,490836,462416,28420,2364
14-08-2021,Thiruvananthapuram,33765,29952,3813,228
14-08-2021,Kollam,28895,26522,2373,267
14-08-2021,Pathanamthitta,10665,9010,1655,126
14-08-2021,Alappuzha,21239,19007,2232,165
14-08-2021,Kottayam,42679,40378,2301,144
14-08-2021,Idukki,9141,8477,664,21
14-08-2021,Ernakulam,42835,39526,3309,110
14-08-2021,Thrissur,54459,52849,1610,309
14-08-2021,Palakkad,34713,31917,2796,320
14-08-2021,Malappuram,77033,75236,1797,261
14-08-2021,Kozhikode,64108,61649,2459,201
14-08-2021,Wayanad,18633,17127,1506,109
14-08-2021,Kannur,30877,30024,853,85
14-08-2021,Kasaragod,25387,24458,929,61
14-08-2021,total,494429,466132,28297,2407
15-08-2021,Thiruvananthapuram,34271,30481,3790,76
15-08-2021,Kollam,28618,26263,2355,282
15-08-2021,Pathanamthitta,10599,8997,1602,62
15-08-2021,Alappuzha,21308,19086,2222,208
15-08-2021,Kottayam,42792,40785,2007,113
15-08-2021,Idukki,9318,8625,693,31
15-08-2021,Ernakulam,42979,39705,3274,107
15-08-2021,Thrissur,53906,52275,1631,280
15-08-2021,Palakkad,34581,32050,2531,240
15-08-2021,Malappuram,80213,78420,1793,260
15-08-2021,Kozhikode,66061,63611,2450,195
15-08-2021,Wayanad,18648,17155,1493,52
15-08-2021,Kannur,31133,30301,832,89
15-08-2021,Kasaragod,24604,23641,963,70
15-08-2021,total,499031,471395,27636,2065
16-08-2021,Thiruvananthapuram,33580,29803,3777,175
16-08-2021,Kollam,27447,25161,2286,185
16-08-2021,Pathanamthitta,10481,8887,1594,65
16-08-2021,Alappuzha,20931,18781,2150,190
16-08-2021,Kottayam,42030,39780,2250,78
16-08-2021,Idukki,9275,8556,719,24
16-08-2021,Ernakulam,42437,39214,3223,59
16-08-2021,Thrissur,52689,51016,1673,328
16-08-2021,Palakkad,34461,31856,2605,272
16-08-2021,Malappuram,79118,77329,1789,259
16-08-2021,Kozhikode,65368,62838,2530,211
16-08-2021,Wayanad,18435,17000,1435,88
16-08-2021,Kannur,31712,30824,888,116
16-08-2021,Kasaragod,23867,22905,962,25
16-08-2021,total,491831,463950,27881,2075
17-08-2021,Thiruvananthapuram,33560,29783,3777,216
17-08-2021,Kollam,27019,24658,2361,312
17-08-2021,Pathanamthitta,10309,8773,1536,49
17-08-2021,Alappuzha,20991,18835,2156,199
17-08-2021,Kottayam,40213,37967,2246,61
17-08-2021,Idukki,9303,8591,712,19
17-08-2021,Ernakulam,42726,39409,3317,162
17-08-2021,Thrissur,52174,50508,1666,320
17-08-2021,Palakkad,34197,31556,2641,375
17-08-2021,Malappuram,78554,76742,1812,267
17-08-2021,Kozhikode,74777,72216,2561,200
17-08-2021,Wayanad,17514,16086,1428,84
17-08-2021,Kannur,31548,30679,869,108
17-08-2021,Kasaragod,23464,22665,799,37
17-08-2021,total,496349,468468,27881,2409
18-08-2021,Thiruvananthapuram,33116,29320,3796,185
18-08-2021,Kollam,25637,23334,2303,228
18-08-2021,Pathanamthitta,10391,8684,1707,150
18-08-2021,Alappuzha,20733,18619,2114,133
18-08-2021,Kottayam,41482,39242,2240,159
18-08-2021,Idukki,9463,8740,723,55
18-08-2021,Ernakulam,42599,39303,3296,120
18-08-2021,Thrissur,52165,50546,1619,262
18-08-2021,Palakkad,33182,30514,2668,272
18-08-2021,Malappuram,79916,78158,1758,253
18-08-2021,Kozhikode,77888,75275,2613,169
18-08-2021,Wayanad,17330,15974,1356,71
18-08-2021,Kannur,31828,30958,870,119
18-08-2021,Kasaragod,22900,22104,796,49
18-08-2021,total,498630,470771,27859,2225
19-08-2021,Thiruvananthapuram,32226,28430,3796,222
19-08-2021,Kollam,24491,22246,2245,243
19-08-2021,Pathanamthitta,10305,8742,1563,106
19-08-2021,Alappuzha,20675,18518,2157,211
19-08-2021,Kottayam,41809,39571,2238,140
19-08-2021,Idukki,9857,9136,721,22
19-08-2021,Ernakulam,42702,39505,3197,96
19-08-2021,Thrissur,52227,50700,1527,272
19-08-2021,Palakkad,32683,30012,2671,273
19-08-2021,Malappuram,79610,77908,1702,239
19-08-2021,Kozhikode,81597,79030,2567,213
19-08-2021,Wayanad,17207,15908,1299,82
19-08-2021,Kannur,31779,30889,890,113
19-08-2021,Kasaragod,22735,21928,807,51
19-08-2021,total,499903,472523,27380,2283
20-08-2021,Thiruvananthapuram,30925,27243,3682,148
20-08-2021,Kollam,23712,21493,2219,272
20-08-2021,Pathanamthitta,10842,9318,1524,88
20-08-2021,Alappuzha,20396,18345,2051,116
20-08-2021,Kottayam,41702,39532,2170,70
20-08-2021,Idukki,10243,9475,768,34
20-08-2021,Ernakulam,43017,39772,3245,147
20-08-2021,Thrissur,52914,51406,1508,295
20-08-2021,Palakkad,31793,29190,2603,235
20-08-2021,Malappuram,78467,76808,1659,224
20-08-2021,Kozhikode,76015,73478,2537,199
20-08-2021,Wayanad,17370,16007,1363,124
20-08-2021,Kannur,32604,31702,902,137
20-08-2021,Kasaragod,21871,21150,721,32
20-08-2021,total,491871,464919,26952,2121
21-08-2021,Thiruvananthapuram,29815,26118,3697,114
21-08-2021,Kollam,23258,21067,2191,166
21-08-2021,Pathanamthitta,10930,9448,1482,96
21-08-2021,Alappuzha,20758,18762,1996,189
21-08-2021,Kottayam,41739,39720,2019,91
21-08-2021,Idukki,10468,9716,752,18
21-08-2021,Ernakulam,43283,40080,3203,100
21-08-2021,Thrissur,52269,50127,2142,312
21-08-2021,Palakkad,32475,29872,2603,195
21-08-2021,Malappuram,79821,78178,1643,219
21-08-2021,Kozhikode,77458,74895,2563,199
21-08-2021,Wayanad,16763,15439,1324,65
21-08-2021,Kannur,32935,32050,885,86
21-08-2021,Kasaragod,20367,19607,760,51
21-08-2021,total,492339,465079,27260,1901
22-08-2021,Thiruvananthapuram,28416,24719,3697,90
22-08-2021,Kollam,22696,20530,2166,168
22-08-2021,Pathanamthitta,11187,9773,1414,62
22-08-2021,Alappuzha,20025,18163,1862,171
22-08-2021,Kottayam,40766,38785,1981,91
22-08-2021,Idukki,10733,9969,764,24
22-08-2021,Ernakulam,41348,38254,3094,62
22-08-2021,Thrissur,51571,49421,2150,198
22-08-2021,Palakkad,33386,31007,2379,235
22-08-2021,Malappuram,77539,75909,1630,216
22-08-2021,Kozhikode,78262,75827,2435,204
22-08-2021,Wayanad,17043,15719,1324,67
22-08-2021,Kannur,32188,31252,936,88
22-08-2021,Kasaragod,19857,19103,754,28
22-08-2021,total,485017,458431,26586,1704
25-08-2021,Thiruvananthapuram,27295,23588,3707,212
25-08-2021,Kollam,21748,19524,2224,334
25-08-2021,Pathanamthitta,11989,10497,1492,129
25-08-2021,Alappuzha,18932,17149,1783,175
25-08-2021,Kottayam,41159,39037,2122,198
25-08-2021,Idukki,11679,10963,716,39
25-08-2021,Ernakulam,41613,38480,3133,176
25-08-2021,Thrissur,47747,45623,2124,326
25-08-2021,Palakkad,36232,33933,2299,131
25-08-2021,Malappuram,72165,70576,1589,200
25-08-2021,Kozhikode,74137,71558,2579,231
25-08-2021,Wayanad,16444,15244,1200,116
25-08-2021,Kannur,30945,29997,948,117
25-08-2021,Kasaragod,18775,18109,666,55
25-08-2021,total,470860,444278,26582,2439
26-08-2021,Thiruvananthapuram,27602,23754,3848,334
26-08-2021,Kollam,22141,19786,2355,379
26-08-2021,Pathanamthitta,12848,11291,1557,121
26-08-2021,Alappuzha,19414,17518,1896,252
26-08-2021,Kottayam,44398,42126,2272,216
26-08-2021,Idukki,12810,12049,761,89
26-08-2021,Ernakulam,43031,39839,3192,144
26-08-2021,Thrissur,48990,46775,2215,377
26-08-2021,Palakkad,37032,34733,2299,265
26-08-2021,Malappuram,71862,70311,1551,188
26-08-2021,Kozhikode,78888,76273,2615,220
26-08-2021,Wayanad,17089,15800,1289,151
26-08-2021,Kannur,32024,31092,932,115
26-08-2021,Kasaragod,19117,18474,643,39
26-08-2021,total,487246,459821,27425,2890
27-08-2021,Thiruvananthapuram,28298,24303,3995,397
27-08-2021,Kollam,22969,20510,2459,355
27-08-2021,Pathanamthitta,13941,12266,1675,181
27-08-2021,Alappuzha,20032,18052,1980,297
27-08-2021,Kottayam,44455,42010,2445,185
27-08-2021,Idukki,13316,12533,783,29
27-08-2021,Ernakulam,42644,39367,3277,161
27-08-2021,Thrissur,49888,47652,2236,322
27-08-2021,Palakkad,37980,35577,2403,311
27-08-2021,Malappuram,72205,70648,1557,190
27-08-2021,Kozhikode,82676,80060,2616,219
27-08-2021,Wayanad,18328,16841,1487,290
27-08-2021,Kannur,32649,31697,952,112
27-08-2021,Kasaragod,19110,18430,680,52
27-08-2021,total,498491,469946,28545,3101
28-08-2021,Thiruvananthapuram,29443,25361,4082,315
28-08-2021,Kollam,24273,21706,2567,427
28-08-2021,Pathanamthitta,14857,13147,1710,153
28-08-2021,Alappuzha,21163,19073,2090,278
28-08-2021,Kottayam,43183,40564,2619,178
28-08-2021,Idukki,14128,13346,782,40
28-08-2021,Ernakulam,43887,40538,3349,161
28-08-2021,Thrissur,50904,48600,2304,327
28-08-2021,Palakkad,37442,34699,2743,250
28-08-2021,Malappuram,76083,74594,1489,162
28-08-2021,Kozhikode,86047,83458,2589,221
28-08-2021,Wayanad,19292,17750,1542,145
28-08-2021,Kannur,33847,32884,963,96
28-08-2021,Kasaragod,19482,18788,694,39
28-08-2021,total,514031,484508,29523,2792
29-08-2021,Thiruvananthapuram,30763,26635,4128,227
29-08-2021,Kollam,25669,22952,2717,415
29-08-2021,Pathanamthitta,15904,14059,1845,153
29-08-2021,Alappuzha,22576,20360,2216,318
29-08-2021,Kottayam,44996,42293,2703,138
29-08-2021,Idukki,15073,14268,805,33
29-08-2021,Ernakulam,45956,42496,3460,180
29-08-2021,Thrissur,52723,50366,2357,298
29-08-2021,Palakkad,38168,35599,2569,245
29-08-2021,Malappuram,76698,75208,1490,164
29-08-2021,Kozhikode,92070,89396,2674,237
29-08-2021,Wayanad,20002,18563,1439,84
29-08-2021,Kannur,33841,32874,967,131
29-08-2021,Kasaragod,19378,18693,685,43
29-08-2021,total,533817,503762,30055,2666
30-08-2021,Thiruvananthapuram,30729,26470,4259,313
30-08-2021,Kollam,25781,22949,2832,268
30-08-2021,Pathanamthitta,16231,14330,1901,116
30-08-2021,Alappuzha,22793,20466,2327,300
30-08-2021,Kottayam,46399,43647,2752,146
30-08-2021,Idukki,15988,15200,788,22
30-08-2021,Ernakulam,46568,43028,3540,174
30-08-2021,Thrissur,53139,50688,2451,388
30-08-2021,Palakkad,37425,34912,2513,309
30-08-2021,Malappuram,75251,73681,1570,157
30-08-2021,Kozhikode,95160,92403,2757,221
30-08-2021,Wayanad,20567,19106,1461,113
30-08-2021,Kannur,34220,33247,973,78
30-08-2021,Kasaragod,18846,18144,702,36
30-08-2021,total,539097,508271,30826,2641
31-08-2021,Thiruvananthapuram,31359,27031,4328,312
31-08-2021,Kollam,26566,23658,2908,431
31-08-2021,Pathanamthitta,16551,14615,1936,91
31-08-2021,Alappuzha,23376,21000,2376,187
31-08-2021,Kottayam,45453,42524,2929,83
31-08-2021,Idukki,16263,15479,784,9
31-08-2021,Ernakulam,46938,43284,3654,197
31-08-2021,Thrissur,53612,51098,2514,385
31-08-2021,Palakkad,38528,35815,2713,360
31-08-2021,Malappuram,76661,75076,1585,162
31-08-2021,Kozhikode,96211,93371,2840,204
31-08-2021,Wayanad,20908,19372,1536,131
31-08-2021,Kannur,34308,33350,958,107
31-08-2021,Kasaragod,18659,18013,646,39
31-08-2021,total,545393,513686,31707,2698
01-09-2021,Thiruvananthapuram,33423,28924,4499,429
01-09-2021,Kollam,28105,25046,3059,453
01-09-2021,Pathanamthitta,16662,14661,2001,110
01-09-2021,Alappuzha,24119,21623,2496,294
01-09-2021,Kottayam,45940,42952,2988,184
01-09-2021,Idukki,15916,15090,826,48
01-09-2021,Ernakulam,47039,43293,3746,156
01-09-2021,Thrissur,56240,53591,2649,384
01-09-2021,Palakkad,40309,37556,2753,466
01-09-2021,Malappuram,75157,73575,1582,163
01-09-2021,Kozhikode,98760,95904,2856,239
01-09-2021,Wayanad,21736,20108,1628,171
01-09-2021,Kannur,34373,33417,956,93
01-09-2021,Kasaragod,19306,18640,666,37
01-09-2021,total,557085,524380,32705,3227
03-09-2021,Thiruvananthapuram,36808,32229,4579,260
03-09-2021,Kollam,28938,25733,3205,416
03-09-2021,Pathanamthitta,18153,16036,2117,135
03-09-2021,Alappuzha,24033,21384,2649,179
03-09-2021,Kottayam,50509,47547,2962,125
03-09-2021,Idukki,14734,13937,797,18
03-09-2021,Ernakulam,46608,42813,3795,157
03-09-2021,Thrissur,58114,55299,2815,483
03-09-2021,Palakkad,44604,41839,2765,295
03-09-2021,Malappuram,76867,75260,1607,199
03-09-2021,Kozhikode,101124,98243,2881,230
03-09-2021,Wayanad,24973,23264,1709,148
03-09-2021,Kannur,34003,33066,937,134
03-09-2021,Kasaragod,19236,18596,640,50
03-09-2021,total,578704,545246,33458,2829
05-09-2021,Thiruvananthapuram,42669,38076,4593,247
05-09-2021,Kollam,34220,31042,3178,335
05-09-2021,Pathanamthitta,19567,17527,2040,122
05-09-2021,Alappuzha,28102,25420,2682,303
05-09-2021,Kottayam,55439,52537,2902,210
05-09-2021,Idukki,14985,14144,841,13
05-09-2021,Ernakulam,48466,44680,3786,124
05-09-2021,Thrissur,59853,57132,2721,353
05-09-2021,Palakkad,51729,48953,2776,253
05-09-2021,Malappuram,77659,76089,1570,190
05-09-2021,Kozhikode,111265,108433,2832,202
05-09-2021,Wayanad,26571,24895,1676,89
05-09-2021,Kannur,34260,33290,970,111
05-09-2021,Kasaragod,19516,18843,673,52
05-09-2021,total,624301,591061,33240,2604
07-09-2021,Thiruvananthapuram,42865,38194,4671,369
07-09-2021,Kollam,33967,30744,3223,383
07-09-2021,Pathanamthitta,20505,18555,1950,77
07-09-2021,Alappuzha,28315,25695,2620,173
07-09-2021,Kottayam,51484,48656,2828,90
07-09-2021,Idukki,13135,12291,844,18
07-09-2021,Ernakulam,48229,44587,3642,127
07-09-2021,Thrissur,59756,56903,2853,359
07-09-2021,Palakkad,57069,54361,2708,221
07-09-2021,Malappuram,74643,73115,1528,176
07-09-2021,Kozhikode,107543,104741,2802,191
07-09-2021,Wayanad,27379,25746,1633,134
07-09-2021,Kannur,34410,33444,966,108
07-09-2021,Kasaragod,19384,18717,667,38
07-09-2021,total,618684,585749,32935,2464
08-09-2021,Thiruvananthapuram,42219,37527,4692,318
08-09-2021,Kollam,33385,30095,3290,389
08-09-2021,Pathanamthitta,19170,17234,1936,131
08-09-2021,Alappuzha,28220,25597,2623,250
08-09-2021,Kottayam,49883,47028,2855,130
08-09-2021,Idukki,13371,12548,823,27
08-09-2021,Ernakulam,48416,44839,3577,107
08-09-2021,Thrissur,60405,57523,2882,341
08-09-2021,Palakkad,60274,57665,2609,257
08-09-2021,Malappuram,,,,
08-09-2021,Kozhikode,,,,
08-09-2021,Wayanad,,,,
08-09-2021,Kannur,,,,
08-09-2021,Kasaragod,,,,
08-09-2021,total,,,,
10-09-2021,Thiruvananthapuram,45147,40502,4645,284
10-09-2021,Kollam,35027,31926,3101,353
10-09-2021,Pathanamthitta,18571,16648,1923,134
10-09-2021,Alappuzha,28036,25402,2634,256
10-09-2021,Kottayam,51817,48998,2819,120
10-09-2021,Idukki,13410,12659,751,20
10-09-2021,Ernakulam,53740,50256,3484,92
10-09-2021,Thrissur,66874,64029,2845,295
10-09-2021,Palakkad,63113,60501,2612,214
10-09-2021,Malappuram,66287,64811,1476,159
10-09-2021,Kozhikode,98188,95565,2623,215
10-09-2021,Wayanad,27582,25919,1663,119
10-09-2021,Kannur,34078,33082,996,116
10-09-2021,Kasaragod,19169,18486,683,35
10-09-2021,total,621039,588784,32255,2412
11-09-2021,Thiruvananthapuram,44957,40312,4645,246
11-09-2021,Kollam,34463,31498,2965,320
11-09-2021,Pathanamthitta,17761,15990,1771,69
11-09-2021,Alappuzha,27964,25422,2542,180
11-09-2021,Kottayam,51607,48855,2752,155
11-09-2021,Idukki,13833,13107,726,30
11-09-2021,Ernakulam,50899,47499,3400,68
11-09-2021,Thrissur,68388,65585,2803,319
11-09-2021,Palakkad,65087,62572,2515,271
11-09-2021,Malappuram,64836,63357,1479,161
11-09-2021,Kozhikode,94253,91502,2751,250
11-09-2021,Wayanad,26988,25362,1626,80
11-09-2021,Kannur,33867,32870,997,104
11-09-2021,Kasaragod,18592,17927,665,19
11-09-2021,total,613495,581858,31637,2272
12-09-2021,Thiruvananthapuram,45080,40517,4563,237
12-09-2021,Kollam,34477,31605,2872,289
12-09-2021,Pathanamthitta,16953,15244,1709,72
12-09-2021,Alappuzha,27408,25019,2389,166
12-09-2021,Kottayam,50609,47970,2639,105
12-09-2021,Idukki,13386,12704,682,12
12-09-2021,Ernakulam,48940,45641,3299,68
12-09-2021,Thrissur,67144,64428,2716,272
12-09-2021,Palakkad,68377,65938,2439,225
12-09-2021,Malappuram,61703,60300,1403,132
12-09-2021,Kozhikode,91750,89104,2646,214
12-09-2021,Wayanad,26841,25276,1565,83
12-09-2021,Kannur,32969,31989,980,86
12-09-2021,Kasaragod,17678,17026,652,32
12-09-2021,total,603315,572761,30554,1993
15-09-2021,Thiruvananthapuram,43156,38706,4450,288
15-09-2021,Kollam,30662,28134,2528,214
15-09-2021,Pathanamthitta,14740,13349,1391,74
15-09-2021,Alappuzha,24205,22146,2059,111
15-09-2021,Kottayam,51773,49251,2522,78
15-09-2021,Idukki,11802,11058,744,23
15-09-2021,Ernakulam,41189,38235,2954,59
15-09-2021,Thrissur,59537,56984,2553,257
15-09-2021,Palakkad,66344,64189,2155,217
15-09-2021,Malappuram,59192,57857,1335,107
15-09-2021,Kozhikode,86223,83840,2383,125
15-09-2021,Wayanad,24926,23480,1446,59
15-09-2021,Kannur,31185,30298,887,88
15-09-2021,Kasaragod,16305,15663,642,18
15-09-2021,total,561239,533190,28049,1718
17-09-2021,Thiruvananthapuram,43176,38891,4285,312
17-09-2021,Kollam,28459,26271,2188,242
17-09-2021,Pathanamthitta,13249,11968,1281,112
17-09-2021,Alappuzha,23518,21648,1870,83
17-09-2021,Kottayam,51846,49398,2448,106
17-09-2021,Idukki,11069,10320,749,28
17-09-2021,Ernakulam,40419,37593,2826,104
17-09-2021,Thrissur,59952,57608,2344,281
17-09-2021,Palakkad,61283,59311,1972,226
17-09-2021,Malappuram,57297,55972,1325,103
17-09-2021,Kozhikode,77674,75446,2228,148
17-09-2021,Wayanad,23341,21938,1403,70
17-09-2021,Kannur,30489,29677,812,70
17-09-2021,Kasaragod,16051,15420,631,14
17-09-2021,total,537823,511461,26362,1899
19-09-2021,Thiruvananthapuram,43333,39040,4293,253
19-09-2021,Kollam,27510,25414,2096,226
19-09-2021,Pathanamthitta,12942,11688,1254,82
19-09-2021,Alappuzha,22472,20671,1801,235
19-09-2021,Kottayam,51309,49008,2301,95
19-09-2021,Idukki,10755,10070,685,15
19-09-2021,Ernakulam,35918,33168,2750,89
19-09-2021,Thrissur,56855,54591,2264,257
19-09-2021,Palakkad,57767,55883,1884,187
19-09-2021,Malappuram,55281,53973,1308,98
19-09-2021,Kozhikode,72719,70760,1959,134
19-09-2021,Wayanad,21704,20449,1255,81
19-09-2021,Kannur,29317,28558,759,60
19-09-2021,Kasaragod,14972,14314,658,94
19-09-2021,total,512854,487587,25267,1906
20-09-2021,Thiruvananthapuram,42462,38169,4293,257
20-09-2021,Kollam,26900,24938,1962,213
20-09-2021,Pathanamthitta,13043,11796,1247,63
20-09-2021,Alappuzha,21805,20119,1686,103
20-09-2021,Kottayam,49781,47490,2291,45
20-09-2021,Idukki,10437,9754,683,15
20-09-2021,Ernakulam,33573,30873,2700,82
20-09-2021,Thrissur,52528,50291,2237,233
20-09-2021,Palakkad,57097,55305,1792,177
20-09-2021,Malappuram,55325,54047,1278,88
20-09-2021,Kozhikode,69481,67543,1938,106
20-09-2021,Wayanad,20685,19451,1234,63
20-09-2021,Kannur,28565,27822,743,48
20-09-2021,Kasaragod,14421,13801,620,14
20-09-2021,total,496103,471399,24704,1507
21-09-2021,Thiruvananthapuram,42411,38163,4248,237
21-09-2021,Kollam,26651,24709,1942,268
21-09-2021,Pathanamthitta,12798,11608,1190,50
21-09-2021,Alappuzha,21985,20322,1663,160
21-09-2021,Kottayam,49735,47557,2178,79
21-09-2021,Idukki,9378,8733,645,18
21-09-2021,Ernakulam,34668,32103,2565,66
21-09-2021,Thrissur,49046,46833,2213,246
21-09-2021,Palakkad,56105,54451,1654,195
21-09-2021,Malappuram,55208,53912,1296,94
21-09-2021,Kozhikode,67492,65658,1834,97
21-09-2021,Wayanad,19689,18467,1222,68
21-09-2021,Kannur,27321,26580,741,84
21-09-2021,Kasaragod,14113,13595,518,14
21-09-2021,total,486600,462691,23909,1676
22-09-2021,Thiruvananthapuram,43336,39088,4248,277
22-09-2021,Kollam,26094,24223,1871,222
22-09-2021,Pathanamthitta,12647,11454,1193,70
22-09-2021,Alappuzha,21189,19547,1642,162
22-09-2021,Kottayam,50822,48696,2126,103
22-09-2021,Idukki,9158,8528,630,16
22-09-2021,Ernakulam,36357,33907,2450,41
22-09-2021,Thrissur,51969,49797,2172,231
22-09-2021,Palakkad,54669,53074,1595,187
22-09-2021,Malappuram,54799,53493,1306,98
22-09-2021,Kozhikode,62425,60620,1805,162
22-09-2021,Wayanad,18553,17438,1115,41
22-09-2021,Kannur,25469,24770,699,69
22-09-2021,Kasaragod,13708,13187,521,22
22-09-2021,total,481195,457822,23373,1701
23-09-2021,Thiruvananthapuram,42789,38604,4185,323
23-09-2021,Kollam,25151,23366,1785,188
23-09-2021,Pathanamthitta,12205,11078,1127,100
23-09-2021,Alappuzha,20495,18930,1565,103
23-09-2021,Kottayam,51854,49777,2077,73
23-09-2021,Idukki,12532,11889,643,26
23-09-2021,Ernakulam,36551,34110,2441,89
23-09-2021,Thrissur,54509,52378,2131,221
23-09-2021,Palakkad,52911,51409,1502,132
23-09-2021,Malappuram,53873,52625,1248,76
23-09-2021,Kozhikode,56466,54677,1789,147
23-09-2021,Wayanad,17964,16834,1130,124
23-09-2021,Kannur,24551,23880,671,67
23-09-2021,Kasaragod,13252,12725,527,20
23-09-2021,total,475103,452282,22821,1689
24-09-2021,Thiruvananthapuram,41342,37184,4158,299
24-09-2021,Kollam,29987,28223,1764,204
24-09-2021,Pathanamthitta,13205,12025,1180,108
24-09-2021,Alappuzha,20489,18943,1546,133
24-09-2021,Kottayam,54591,52596,1995,118
24-09-2021,Idukki,11256,10618,638,27
24-09-2021,Ernakulam,37414,35023,2391,74
24-09-2021,Thrissur,55401,53307,2094,255
24-09-2021,Palakkad,49348,47910,1438,190
24-09-2021,Malappuram,50558,49329,1229,70
24-09-2021,Kozhikode,52719,50963,1756,135
24-09-2021,Wayanad,17632,16473,1159,110
24-09-2021,Kannur,22961,22291,670,69
24-09-2021,Kasaragod,13051,12557,494,15
24-09-2021,total,469954,447442,22512,1807
26-09-2021,Thiruvananthapuram,42055,37836,4219,171
26-09-2021,Kollam,37108,35443,1665,181
26-09-2021,Pathanamthitta,13379,12169,1210,106
26-09-2021,Alappuzha,20243,18821,1422,66
26-09-2021,Kottayam,55719,53793,1926,92
26-09-2021,Idukki,11537,10948,589,20
26-09-2021,Ernakulam,42789,40425,2364,76
26-09-2021,Thrissur,52830,50816,2014,188
26-09-2021,Palakkad,45222,43896,1326,111
26-09-2021,Malappuram,46371,45205,1166,49
26-09-2021,Kozhikode,52348,50705,1643,102
26-09-2021,Wayanad,15892,14824,1068,47
26-09-2021,Kannur,26536,25878,658,81
26-09-2021,Kasaragod,12872,12360,512,22
26-09-2021,total,474901,453119,21782,1312
27-09-2021,Thiruvananthapuram,43705,39536,4169,176
27-09-2021,Kollam,38665,37043,1622,215
27-09-2021,Pathanamthitta,14523,13341,1182,70
27-09-2021,Alappuzha,20945,19536,1409,125
27-09-2021,Kottayam,57121,55265,1856,83
27-09-2021,Idukki,11115,10542,573,5
27-09-2021,Ernakulam,44918,42604,2314,31
27-09-2021,Thrissur,47892,45923,1969,194
27-09-2021,Palakkad,44181,42942,1239,119
27-09-2021,Malappuram,44574,43459,1115,36
27-09-2021,Kozhikode,55259,53595,1664,102
27-09-2021,Wayanad,14834,13840,994,50
27-09-2021,Kannur,27634,26998,636,97
27-09-2021,Kasaragod,12721,12197,524,15
27-09-2021,total,478087,456821,21266,1318
28-09-2021,Thiruvananthapuram,43172,39000,4172,257
28-09-2021,Kollam,40291,38765,1526,165
28-09-2021,Pathanamthitta,15403,14221,1182,63
28-09-2021,Alappuzha,21622,20265,1357,111
28-09-2021,Kottayam,56874,55007,1867,60
28-09-2021,Idukki,10906,10356,550,18
28-09-2021,Ernakulam,44739,42415,2324,111
28-09-2021,Thrissur,40718,38801,1917,199
28-09-2021,Palakkad,41939,40700,1239,120
28-09-2021,Malappuram,42657,41559,1098,30
28-09-2021,Kozhikode,57405,55736,1669,115
28-09-2021,Wayanad,14308,13295,1013,78
28-09-2021,Kannur,28179,27580,599,52
28-09-2021,Kasaragod,12305,11780,525,8
28-09-2021,total,470518,449480,21038,1387
29-09-2021,Thiruvananthapuram,42988,38816,4172,286
29-09-2021,Kollam,39176,37725,1451,163
29-09-2021,Pathanamthitta,15703,14615,1088,44
29-09-2021,Alappuzha,19691,18384,1307,84
29-09-2021,Kottayam,55890,54089,1801,67
29-09-2021,Idukki,10517,9973,544,18
29-09-2021,Ernakulam,44278,42100,2178,57
29-09-2021,Thrissur,36051,34210,1841,193
29-09-2021,Palakkad,38966,37828,1138,126
29-09-2021,Malappuram,41252,40177,1075,28
29-09-2021,Kozhikode,57408,55812,1596,111
29-09-2021,Wayanad,14630,13679,951,28
29-09-2021,Kannur,28252,27701,551,63
29-09-2021,Kasaragod,12150,11728,422,16
29-09-2021,total,456952,436837,20115,1284
30-09-2021,Thiruvananthapuram,41525,37486,4039,229
30-09-2021,Kollam,40369,38981,1388,130
30-09-2021,Pathanamthitta,15870,14840,1030,49
30-09-2021,Alappuzha,19484,18316,1168,79
30-09-2021,Kottayam,55027,53298,1729,51
30-09-2021,Idukki,9640,9109,531,17
30-09-2021,Ernakulam,44287,42155,2132,71
30-09-2021,Thrissur,34722,33227,1495,220
30-09-2021,Palakkad,34940,33871,1069,98
30-09-2021,Malappuram,40208,39179,1029,32
30-09-2021,Kozhikode,56955,55409,1546,99
30-09-2021,Wayanad,14129,13329,800,37
30-09-2021,Kannur,27688,27127,561,89
30-09-2021,Kasaragod,11974,11608,366,3
30-09-2021,total,446818,427935,18883,1204
01-10-2021,Thiruvananthapuram,40918,37106,3812,250
01-10-2021,Kollam,41200,39838,1362,151
01-10-2021,Pathanamthitta,14829,13793,1036,101
01-10-2021,Alappuzha,19367,18299,1068,56
01-10-2021,Kottayam,54550,52855,1695,72
01-10-2021,Idukki,9494,8976,518,20
01-10-2021,Ernakulam,43938,41871,2067,43
01-10-2021,Thrissur,32923,31636,1287,164
01-10-2021,Palakkad,34419,33412,1007,115
01-10-2021,Malappuram,39898,38842,1056,43
01-10-2021,Kozhikode,55920,54460,1460,97
01-10-2021,Wayanad,14066,13333,733,49
01-10-2021,Kannur,27281,26758,523,52
01-10-2021,Kasaragod,11391,11039,352,9
01-10-2021,total,440194,422218,17976,1222
02-10-2021,Thiruvananthapuram,40038,36278,3760,173
02-10-2021,Kollam,41669,40326,1343,144
02-10-2021,Pathanamthitta,13952,12959,993,55
02-10-2021,Alappuzha,19006,17963,1043,243
02-10-2021,Kottayam,54428,52812,1616,59
02-10-2021,Idukki,9612,9105,507,25
02-10-2021,Ernakulam,43498,41554,1944,56
02-10-2021,Thrissur,31814,30655,1159,194
02-10-2021,Palakkad,34200,33193,1007,159
02-10-2021,Malappuram,41995,41049,946,31
02-10-2021,Kozhikode,55732,54315,1417,88
02-10-2021,Wayanad,14619,13901,718,88
02-10-2021,Kannur,26483,25984,499,55
02-10-2021,Kasaragod,10818,10462,356,8
02-10-2021,total,437864,420556,17308,1378
03-10-2021,Thiruvananthapuram,39624,35864,3760,197
03-10-2021,Kollam,42417,41213,1204,104
03-10-2021,Pathanamthitta,12199,11292,907,47
03-10-2021,Alappuzha,18759,17811,948,43
03-10-2021,Kottayam,54623,53146,1477,49
03-10-2021,Idukki,9387,8887,500,9
03-10-2021,Ernakulam,42693,40842,1851,121
03-10-2021,Thrissur,31105,29874,1231,193
03-10-2021,Palakkad,33971,33033,938,114
03-10-2021,Malappuram,41897,41013,884,29
03-10-2021,Kozhikode,53392,51971,1421,98
03-10-2021,Wayanad,14887,14178,709,33
03-10-2021,Kannur,24005,23505,500,52
03-10-2021,Kasaragod,10622,10273,349,12
03-10-2021,total,429581,412902,16679,1101
04-10-2021,Thiruvananthapuram,38959,35265,3694,192
04-10-2021,Kollam,41779,40583,1196,149
04-10-2021,Pathanamthitta,11624,10744,880,36
04-10-2021,Alappuzha,17780,16929,851,45
04-10-2021,Kottayam,53667,52230,1437,31
04-10-2021,Idukki,8992,8541,451,5
04-10-2021,Ernakulam,40280,38432,1848,69
04-10-2021,Thrissur,27886,26686,1200,173
04-10-2021,Palakkad,32170,31252,918,102
04-10-2021,Malappuram,42611,41707,904,36
04-10-2021,Kozhikode,52790,51368,1422,113
04-10-2021,Wayanad,14840,14232,608,24
04-10-2021,Kannur,21645,21144,501,39
04-10-2021,Kasaragod,10466,10115,351,5
04-10-2021,total,415489,399228,16261,1019
06-10-2021,Thiruvananthapuram,42014,38370,3644,149
06-10-2021,Kollam,40308,39221,1087,102
06-10-2021,Pathanamthitta,11515,10733,782,44
06-10-2021,Alappuzha,17159,16303,856,56
06-10-2021,Kottayam,47203,45917,1286,47
06-10-2021,Idukki,7825,7400,425,10
06-10-2021,Ernakulam,36173,34495,1678,23
06-10-2021,Thrissur,25302,24179,1123,166
06-10-2021,Palakkad,27628,26778,850,74
06-10-2021,Malappuram,40230,39330,900,36
06-10-2021,Kozhikode,50637,49285,1352,105
06-10-2021,Wayanad,14164,13672,492,32
06-10-2021,Kannur,19910,19404,506,65
06-10-2021,Kasaragod,10563,10219,344,9
06-10-2021,total,390631,375306,15325,918
07-10-2021,Thiruvananthapuram,43629,40274,3355,199
07-10-2021,Kollam,35461,34467,994,106
07-10-2021,Pathanamthitta,11460,10699,761,63
07-10-2021,Alappuzha,17308,16508,800,37
07-10-2021,Kottayam,44266,43055,1211,45
07-10-2021,Idukki,7935,7471,464,18
07-10-2021,Ernakulam,34381,32684,1697,71
07-10-2021,Thrissur,23083,22101,982,130
07-10-2021,Palakkad,25843,25088,755,75
07-10-2021,Malappuram,41005,40110,895,34
07-10-2021,Kozhikode,48594,47197,1397,107
07-10-2021,Wayanad,13747,13239,508,43
07-10-2021,Kannur,19786,19291,495,59
07-10-2021,Kasaragod,10630,10260,370,29
07-10-2021,total,377128,362444,14684,1016
09-10-2021,Thiruvananthapuram,49227,46237,2990,211
09-10-2021,Kollam,27607,26729,878,93
09-10-2021,Pathanamthitta,12097,11486,611,54
09-10-2021,Alappuzha,14614,13876,738,54
09-10-2021,Kottayam,41472,40359,1113,45
09-10-2021,Idukki,8320,7885,435,4
09-10-2021,Ernakulam,34458,32820,1638,54
09-10-2021,Thrissur,25095,24195,900,133
09-10-2021,Palakkad,22651,21928,723,75
09-10-2021,Malappuram,40336,39508,828,24
09-10-2021,Kozhikode,44622,43222,1400,88
09-10-2021,Wayanad,13453,13113,340,40
09-10-2021,Kannur,21700,21237,463,43
09-10-2021,Kasaragod,10598,10256,342,9
09-10-2021,total,366250,352851,13399,927
11-10-2021,Thiruvananthapuram,51742,48980,2762,140
11-10-2021,Kollam,25881,25065,816,81
11-10-2021,Pathanamthitta,10962,10255,707,29
11-10-2021,Alappuzha,13006,12341,665,55
11-10-2021,Kottayam,39597,38647,950,9
11-10-2021,Idukki,8295,7891,404,16
11-10-2021,Ernakulam,28965,27406,1559,21
11-10-2021,Thrissur,27077,26248,829,112
11-10-2021,Palakkad,22914,22221,693,63
11-10-2021,Malappuram,39778,38963,815,27
11-10-2021,Kozhikode,42914,41876,1038,38
11-10-2021,Wayanad,12423,12089,334,35
11-10-2021,Kannur,21378,20938,440,36
11-10-2021,Kasaragod,9788,9447,341,15
11-10-2021,total,354720,342367,12353,677
13-10-2021,Thiruvananthapuram,51442,48985,2457,163
13-10-2021,Kollam,23478,22790,688,66
13-10-2021,Pathanamthitta,11715,11075,640,29
13-10-2021,Alappuzha,11784,11196,588,31
13-10-2021,Kottayam,36816,35932,884,0
13-10-2021,Idukki,7962,7586,376,18
13-10-2021,Ernakulam,28787,27336,1451,22
13-10-2021,Thrissur,26723,25932,791,125
13-10-2021,Palakkad,19480,18813,667,72
13-10-2021,Malappuram,36034,35285,749,22
13-10-2021,Kozhikode,42236,41301,935,57
13-10-2021,Wayanad,11381,11102,279,28
13-10-2021,Kannur,21882,21464,418,48
13-10-2021,Kasaragod,9968,9629,339,9
13-10-2021,total,339688,328426,11262,690
14-10-2021,Thiruvananthapuram,50365,47964,2401,134
14-10-2021,Kollam,22312,21632,680,100
14-10-2021,Pathanamthitta,11423,10847,576,28
14-10-2021,Alappuzha,11039,10475,564,21
14-10-2021,Kottayam,36719,35865,854,29
14-10-2021,Idukki,8127,7768,359,9
14-10-2021,Ernakulam,30733,29289,1444,63
14-10-2021,Thrissur,26840,26091,749,104
14-10-2021,Palakkad,17907,17271,636,74
14-10-2021,Malappuram,34940,34126,814,46
14-10-2021,Kozhikode,41191,40253,938,58
14-10-2021,Wayanad,10218,9974,244,41
14-10-2021,Kannur,21661,21254,407,48
14-10-2021,Kasaragod,10159,9839,320,16
14-10-2021,total,333634,322648,10986,771
15-10-2021,Thiruvananthapuram,49633,47315,2318,145
15-10-2021,Kollam,21461,20800,661,71
15-10-2021,Pathanamthitta,11512,10951,561,37
15-10-2021,Alappuzha,10607,10075,532,18
15-10-2021,Kottayam,36645,35819,826,17
15-10-2021,Idukki,8549,8218,331,12
15-10-2021,Ernakulam,31452,30045,1407,55
15-10-2021,Thrissur,27462,26736,726,127
15-10-2021,Palakkad,16653,16017,636,116
15-10-2021,Malappuram,30693,29979,714,38
15-10-2021,Kozhikode,42262,41323,939,58
15-10-2021,Wayanad,9927,9685,242,30
15-10-2021,Kannur,20551,20159,392,34
15-10-2021,Kasaragod,10275,9938,337,23
15-10-2021,total,327682,317060,10622,781
17-10-2021,Thiruvananthapuram,46305,44036,2269,241
17-10-2021,Kollam,20655,20067,588,76
17-10-2021,Pathanamthitta,11047,10537,510,20
17-10-2021,Alappuzha,10059,9523,536,75
17-10-2021,Kottayam,34151,33389,762,5
17-10-2021,Idukki,8252,7943,309,5
17-10-2021,Ernakulam,32820,31422,1398,70
17-10-2021,Thrissur,24264,23571,693,93
17-10-2021,Palakkad,16410,15838,572,165
17-10-2021,Malappuram,29148,28483,665,27
17-10-2021,Kozhikode,39177,38219,958,53
17-10-2021,Wayanad,9623,9388,235,25
17-10-2021,Kannur,19129,18760,369,36
17-10-2021,Kasaragod,10321,9980,341,10
17-10-2021,total,311361,301156,10205,901
19-10-2021,Thiruvananthapuram,44476,42294,2182,238
19-10-2021,Kollam,18111,17544,567,93
19-10-2021,Pathanamthitta,11242,10767,475,17
19-10-2021,Alappuzha,9356,8829,527,73
19-10-2021,Kottayam,29990,29303,687,9
19-10-2021,Idukki,8342,8037,305,11
19-10-2021,Ernakulam,34072,32649,1423,92
19-10-2021,Thrissur,22233,21601,632,96
19-10-2021,Palakkad,15827,15333,494,52
19-10-2021,Malappuram,25199,24558,641,22
19-10-2021,Kozhikode,38463,37496,967,59
19-10-2021,Wayanad,8605,8424,181,37
19-10-2021,Kannur,17467,17107,360,46
19-10-2021,Kasaragod,9795,9426,369,9
19-10-2021,total,293178,283368,9810,854
20-10-2021,Thiruvananthapuram,43710,41594,2116,137
20-10-2021,Kollam,17327,16748,579,73
20-10-2021,Pathanamthitta,10865,10357,508,50
20-10-2021,Alappuzha,9220,8716,504,73
20-10-2021,Kottayam,29797,29136,661,15
20-10-2021,Idukki,8098,7834,264,11
20-10-2021,Ernakulam,35214,33821,1393,47
20-10-2021,Thrissur,21195,20575,620,85
20-10-2021,Palakkad,15978,15515,463,52
20-10-2021,Malappuram,24724,24078,646,24
20-10-2021,Kozhikode,38579,37615,964,78
20-10-2021,Wayanad,8412,8233,179,22
20-10-2021,Kannur,16521,16171,350,29
20-10-2021,Kasaragod,10026,9645,381,11
20-10-2021,total,289666,280038,9628,707
21-10-2021,Thiruvananthapuram,43977,41955,2022,150
21-10-2021,Kollam,16765,16197,568,71
21-10-2021,Pathanamthitta,10032,9550,482,31
21-10-2021,Alappuzha,8671,8303,368,25
21-10-2021,Kottayam,29726,29085,641,20
21-10-2021,Idukki,7531,7276,255,24
21-10-2021,Ernakulam,37431,36087,1344,52
21-10-2021,Thrissur,19892,19279,613,98
21-10-2021,Palakkad,15736,15273,463,46
21-10-2021,Malappuram,23741,23199,542,18
21-10-2021,Kozhikode,38919,38133,786,53
21-10-2021,Wayanad,8351,8175,176,30
21-10-2021,Kannur,16327,15980,347,35
21-10-2021,Kasaragod,9789,9415,374,14
21-10-2021,total,286888,277907,8981,667
22-10-2021,Thiruvananthapuram,44077,42142,1935,237
22-10-2021,Kollam,18007,17407,600,84
22-10-2021,Pathanamthitta,9987,9500,487,44
22-10-2021,Alappuzha,8510,8073,437,83
22-10-2021,Kottayam,28977,28323,654,26
22-10-2021,Idukki,7606,7393,213,17
22-10-2021,Ernakulam,38605,37268,1337,68
22-10-2021,Thrissur,17696,17112,584,95
22-10-2021,Palakkad,15518,15095,423,43
22-10-2021,Malappuram,21314,20740,574,26
22-10-2021,Kozhikode,38142,37344,798,45
22-10-2021,Wayanad,8146,7986,160,24
22-10-2021,Kannur,15251,14951,300,23
22-10-2021,Kasaragod,9450,9078,372,10
22-10-2021,total,281286,272412,8874,825
23-10-2021,Thiruvananthapuram,44064,42117,1947,155
23-10-2021,Kollam,17922,17334,588,93
23-10-2021,Pathanamthitta,8825,8328,497,51
23-10-2021,Alappuzha,8414,7953,461,83
23-10-2021,Kottayam,25625,24950,675,18
23-10-2021,Idukki,7583,7375,208,23
23-10-2021,Ernakulam,39595,38323,1272,36
23-10-2021,Thrissur,15180,14632,548,63
23-10-2021,Palakkad,15122,14722,400,68
23-10-2021,Malappuram,19799,19257,542,17
23-10-2021,Kozhikode,37400,36601,799,54
23-10-2021,Wayanad,7656,7498,158,23
23-10-2021,Kannur,14199,13879,320,32
23-10-2021,Kasaragod,9046,8686,360,9
23-10-2021,total,270430,261655,8775,725
24-10-2021,Thiruvananthapuram,44537,42552,1985,133
24-10-2021,Kollam,17786,17214,572,65
24-10-2021,Pathanamthitta,8924,8409,515,37
24-10-2021,Alappuzha,8383,7922,461,0
24-10-2021,Kottayam,26793,26138,655,12
24-10-2021,Idukki,7642,7445,197,9
24-10-2021,Ernakulam,41170,39922,1248,59
24-10-2021,Thrissur,13682,13197,485,49
24-10-2021,Palakkad,14222,13834,388,52
24-10-2021,Malappuram,18907,18372,535,16
24-10-2021,Kozhikode,37165,36366,799,45
24-10-2021,Wayanad,7532,7382,150,19
24-10-2021,Kannur,14438,14136,302,39
24-10-2021,Kasaragod,8700,8363,337,10
24-10-2021,total,269881,261252,8629,545
25-10-2021,Thiruvananthapuram,45589,43586,2003,137
25-10-2021,Kollam,18342,17728,614,92
25-10-2021,Pathanamthitta,8750,8252,498,21
25-10-2021,Alappuzha,8197,7926,457,53
25-10-2021,Kottayam,25272,24602,670,13
25-10-2021,Idukki,7076,6807,269,19
25-10-2021,Ernakulam,41615,40342,1273,48
25-10-2021,Thrissur,14202,13714,488,80
25-10-2021,Palakkad,12855,12477,378,52
25-10-2021,Malappuram,18739,18199,540,18
25-10-2021,Kozhikode,35579,34836,743,20
25-10-2021,Wayanad,7503,7344,159,23
25-10-2021,Kannur,13657,13337,320,42
25-10-2021,Kasaragod,8619,8279,340,6
25-10-2021,total,265995,257429,8752,624
26-10-2021,Thiruvananthapuram,45590,43587,2003,131
26-10-2021,Kollam,18180,17567,613,93
26-10-2021,Pathanamthitta,8725,8234,491,20
26-10-2021,Alappuzha,7776,7320,456,70
26-10-2021,Kottayam,25074,24425,649,4
26-10-2021,Idukki,7200,6947,253,7
26-10-2021,Ernakulam,42318,41096,1222,44
26-10-2021,Thrissur,13702,13249,453,71
26-10-2021,Palakkad,11771,11393,378,68
26-10-2021,Malappuram,24679,24148,531,15
26-10-2021,Kozhikode,34972,34231,741,32
26-10-2021,Wayanad,7583,7426,157,19
26-10-2021,Kannur,13677,13375,302,38
26-10-2021,Kasaragod,8515,8199,316,2
26-10-2021,total,269762,261197,8565,614
27-10-2021,Thiruvananthapuram,45494,43622,1872,155
27-10-2021,Kollam,18380,17781,599,94
27-10-2021,Pathanamthitta,9206,8714,492,27
27-10-2021,Alappuzha,7522,7143,379,12
27-10-2021,Kottayam,24998,24353,645,14
27-10-2021,Idukki,6882,6580,302,14
27-10-2021,Ernakulam,43418,42254,1164,45
27-10-2021,Thrissur,14029,13579,450,76
27-10-2021,Palakkad,11566,11233,333,67
27-10-2021,Malappuram,22838,22295,543,19
27-10-2021,Kozhikode,34551,33812,739,42
27-10-2021,Wayanad,7604,7449,155,19
27-10-2021,Kannur,13575,13293,282,24
27-10-2021,Kasaragod,8576,8251,325,11
27-10-2021,total,268639,260359,8280,619
28-10-2021,Thiruvananthapuram,45246,43485,1761,156
28-10-2021,Kollam,19037,18448,589,77
28-10-2021,Pathanamthitta,8843,8347,496,33
28-10-2021,Alappuzha,7328,6971,357,21
28-10-2021,Kottayam,24658,24021,637,15
28-10-2021,Idukki,7048,6748,300,16
28-10-2021,Ernakulam,45304,44133,1171,66
28-10-2021,Thrissur,13809,13374,435,66
28-10-2021,Palakkad,11650,11447,203,67
28-10-2021,Malappuram,22415,21912,503,13
28-10-2021,Kozhikode,33823,33130,693,57
28-10-2021,Wayanad,7564,7406,158,29
28-10-2021,Kannur,13143,12870,273,21
28-10-2021,Kasaragod,8355,8026,329,6
28-10-2021,total,268223,260318,7905,643
29-10-2021,Thiruvananthapuram,47320,45604,1716,85
29-10-2021,Kollam,19516,18924,592,58
29-10-2021,Pathanamthitta,9966,9493,473,25
29-10-2021,Alappuzha,7073,6753,320,39
29-10-2021,Kottayam,23526,22927,599,20
29-10-2021,Idukki,6607,6305,302,10
29-10-2021,Ernakulam,44854,43785,1069,42
29-10-2021,Thrissur,14093,13669,424,76
29-10-2021,Palakkad,11129,10924,205,42
29-10-2021,Malappuram,23199,22733,466,9
29-10-2021,Kozhikode,33287,32592,695,42
29-10-2021,Wayanad,7582,7426,156,28
29-10-2021,Kannur,12751,12492,259,28
29-10-2021,Kasaragod,8548,8215,333,10
29-10-2021,total,269451,261842,7609,514
30-10-2021,Thiruvananthapuram,49189,47502,1687,128
30-10-2021,Kollam,20437,19887,550,58
30-10-2021,Pathanamthitta,10523,10079,444,25
30-10-2021,Alappuzha,6873,6590,283,19
30-10-2021,Kottayam,23697,23079,618,12
30-10-2021,Idukki,6833,6563,270,13
30-10-2021,Ernakulam,46541,45667,874,51
30-10-2021,Thrissur,14320,13896,424,60
30-10-2021,Palakkad,10513,10195,318,90
30-10-2021,Malappuram,23338,22875,463,8
30-10-2021,Kozhikode,33691,33008,683,55
30-10-2021,Wayanad,7900,7755,145,20
30-10-2021,Kannur,12698,12405,293,49
30-10-2021,Kasaragod,8632,8334,298,9
30-10-2021,total,275185,267835,7350,597
31-10-2021,Thiruvananthapuram,51058,49371,1687,128
31-10-2021,Kollam,20826,20282,544,60
31-10-2021,Pathanamthitta,10251,9809,442,18
31-10-2021,Alappuzha,6629,6393,236,18
31-10-2021,Kottayam,24775,24162,613,19
31-10-2021,Idukki,6705,6439,266,8
31-10-2021,Ernakulam,44174,43290,884,22
31-10-2021,Thrissur,14270,13864,406,54
31-10-2021,Palakkad,10096,9778,318,61
31-10-2021,Malappuram,22251,21791,460,11
31-10-2021,Kozhikode,32625,31952,673,35
31-10-2021,Wayanad,7898,7749,149,31
31-10-2021,Kannur,12056,11759,297,46
31-10-2021,Kasaragod,8634,8333,301,4
31-10-2021,total,272248,264972,7276,515
02-11-2021,Thiruvananthapuram,51058,49371,,
02-11-2021,Kollam,21621,21105,516,43
02-11-2021,Pathanamthitta,9617,9187,430,7
02-11-2021,Alappuzha,5794,5579,215,35
02-11-2021,Kottayam,23848,23254,594,5
02-11-2021,Idukki,6581,6317,264,4
02-11-2021,Ernakulam,41259,40414,845,51
02-11-2021,Thrissur,13667,13302,365,49
02-11-2021,Palakkad,9825,9825,,
02-11-2021,Malappuram,20912,20470,442,
02-11-2021,Kozhikode,30730,30191,539,19
02-11-2021,Wayanad,7735,7586,149,0
02-11-2021,Kannur,11539,11306,233,10
02-11-2021,Kasaragod,8268,7974,294,7
02-11-2021,total,262454,255881,4886,230
03-11-2021,Thiruvananthapuram,51058,51058,,0
03-11-2021,Kollam,21703,21272,431,38
03-11-2021,Pathanamthitta,10757,10331,426,5
03-11-2021,Alappuzha,5627,5407,220,23
03-11-2021,Kottayam,24450,23856,594,10
03-11-2021,Idukki,6119,5846,273,6
03-11-2021,Ernakulam,40877,40020,857,76
03-11-2021,Thrissur,13770,13394,376,45
03-11-2021,Palakkad,9636,9478,158,20
03-11-2021,Malappuram,21176,20628,548,
03-11-2021,Kozhikode,29649,29132,517,24
03-11-2021,Wayanad,7503,7361,142,66
03-11-2021,Kannur,10544,10327,217,
03-11-2021,Kasaragod,8221,7922,299,13
03-11-2021,total,261090,256032,5058,326
04-11-2021,Thiruvananthapuram,51058,51058,,
04-11-2021,Kollam,19681,19252,429,54
04-11-2021,Pathanamthitta,10925,10500,425,34
04-11-2021,Alappuzha,5503,5309,194,19
04-11-2021,Kottayam,23852,23258,594,6
04-11-2021,Idukki,5975,5698,277,10
04-11-2021,Ernakulam,40445,39496,949,155
04-11-2021,Thrissur,14037,13726,311,48
04-11-2021,Palakkad,9527,9360,167,32
04-11-2021,Malappuram,20233,19704,529,18
04-11-2021,Kozhikode,30717,30193,524,18
04-11-2021,Wayanad,7551,7424,127,16
04-11-2021,Kannur,9578,9344,234,48
04-11-2021,Kasaragod,7729,7422,307,15
04-11-2021,total,256811,251744,5067,473
05-11-2021,Thiruvananthapuram,47451,45764,1687,
05-11-2021,Kollam,19618,19228,390,65
05-11-2021,Pathanamthitta,10545,10104,441,14
05-11-2021,Alappuzha,5317,5147,170,17
05-11-2021,Kottayam,23320,22737,583,7
05-11-2021,Idukki,6200,5916,284,10
05-11-2021,Ernakulam,38521,37589,932,86
05-11-2021,Thrissur,14095,13777,318,63
05-11-2021,Palakkad,9398,9257,141,29
05-11-2021,Malappuram,20105,19585,520,19
05-11-2021,Kozhikode,28771,28268,503,31
05-11-2021,Wayanad,8089,7965,124,29
05-11-2021,Kannur,8611,8376,235,67
05-11-2021,Kasaragod,7444,7146,298,5
05-11-2021,total,247485,240859,6626,442
06-11-2021,Thiruvananthapuram,43055,41433,1622,
06-11-2021,Kollam,19917,19502,415,44
06-11-2021,Pathanamthitta,10720,10320,400,13
06-11-2021,Alappuzha,5135,4970,165,26
06-11-2021,Kottayam,23732,23144,588,12
06-11-2021,Idukki,6154,5868,286,6
06-11-2021,Ernakulam,37802,36996,806,49
06-11-2021,Thrissur,14241,13920,321,50
06-11-2021,Palakkad,9574,9409,165,16
06-11-2021,Malappuram,18320,17817,503,15
06-11-2021,Kozhikode,28028,27530,498,23
06-11-2021,Wayanad,8516,8388,128,34
06-11-2021,Kannur,7834,7628,206,34
06-11-2021,Kasaragod,7308,7002,306,10
06-11-2021,total,240336,233927,6409,332
07-11-2021,Thiruvananthapuram,40806,38919,1887,
07-11-2021,Kollam,19971,19554,417,59
07-11-2021,Pathanamthitta,10403,10005,398,8
07-11-2021,Alappuzha,5117,4964,153,26
07-11-2021,Kottayam,23907,23328,579,16
07-11-2021,Idukki,5949,5670,279,8
07-11-2021,Ernakulam,37341,36615,726,21
07-11-2021,Thrissur,14549,14225,324,50
07-11-2021,Palakkad,8731,8558,173,34
07-11-2021,Malappuram,17987,17487,500,16
07-11-2021,Kozhikode,27621,27082,539,36
07-11-2021,Wayanad,8964,8843,121,19
07-11-2021,Kannur,7383,7169,214,27
07-11-2021,Kasaragod,7181,6870,311,7
07-11-2021,total,235910,229289,6621,327
12-11-2021,Thiruvananthapuram,35299,33918,1381,64
12-11-2021,Kollam,18724,18329,395,55
12-11-2021,Pathanamthitta,7880,7476,404,18
12-11-2021,Alappuzha,4731,4573,158,23
12-11-2021,Kottayam,27461,26966,495,0
12-11-2021,Idukki,5346,5118,228,4
12-11-2021,Ernakulam,35464,34837,627,71
12-11-2021,Thrissur,15898,15589,309,63
12-11-2021,Palakkad,8261,8053,208,27
12-11-2021,Malappuram,14296,14007,289,16
12-11-2021,Kozhikode,20604,20172,432,16
12-11-2021,Wayanad,11560,11433,127,30
12-11-2021,Kannur,7155,6945,210,25
12-11-2021,Kasaragod,6192,5877,315,14
12-11-2021,total,218871,213293,5578,426
13-11-2021,Thiruvananthapuram,33576,32187,1389,62
13-11-2021,Kollam,18781,18382,399,30
13-11-2021,Pathanamthitta,7531,7144,387,10
13-11-2021,Alappuzha,9041,8883,158,17
13-11-2021,Kottayam,27927,27458,469,0
13-11-2021,Idukki,5487,5278,209,4
13-11-2021,Ernakulam,35196,34562,634,49
13-11-2021,Thrissur,16011,15896,115,52
13-11-2021,Palakkad,8074,7849,225,23
13-11-2021,Malappuram,13813,13543,270,12
13-11-2021,Kozhikode,24019,23584,435,23
13-11-2021,Wayanad,12605,12494,111,18
13-11-2021,Kannur,7301,7081,220,38
13-11-2021,Kasaragod,5865,5544,321,7
13-11-2021,total,225227,219885,5342,345
16-11-2021,Thiruvananthapuram,28289,26924,1365,144
16-11-2021,Kollam,17959,17579,380,53
16-11-2021,Pathanamthitta,5358,4977,381,5
16-11-2021,Alappuzha,9011,8869,142,15
16-11-2021,Kottayam,29544,29089,455,0
16-11-2021,Idukki,4849,4674,175,4
16-11-2021,Ernakulam,33289,32721,568,24
16-11-2021,Thrissur,15972,15671,301,69
16-11-2021,Palakkad,8055,7875,180,11
16-11-2021,Malappuram,12486,12257,229,12
16-11-2021,Kozhikode,22102,21719,383,24
16-11-2021,Wayanad,13709,13568,141,29
16-11-2021,Kannur,7380,7136,244,28
16-11-2021,Kasaragod,4922,4605,317,8
16-11-2021,total,212925,207664,5261,426
17-11-2021,Thiruvananthapuram,26472,25122,1350,60
17-11-2021,Kollam,18387,18037,350,29
17-11-2021,Pathanamthitta,5043,4654,389,15
17-11-2021,Alappuzha,4926,4774,152,27
17-11-2021,Kottayam,29609,29129,480,0
17-11-2021,Idukki,4640,4461,179,7
17-11-2021,Ernakulam,33783,33216,567,32
17-11-2021,Thrissur,15940,15648,292,38
17-11-2021,Palakkad,8137,8007,130,29
17-11-2021,Malappuram,12354,12140,214,13
17-11-2021,Kozhikode,22414,22059,355,23
17-11-2021,Wayanad,13758,13610,148,23
17-11-2021,Kannur,7511,7271,240,42
17-11-2021,Kasaragod,5030,4709,321,5
17-11-2021,total,208004,202837,5167,343
21-11-2021,Thiruvananthapuram,19242,17901,1341,29
21-11-2021,Kollam,16484,16138,346,30
21-11-2021,Pathanamthitta,5638,5253,385,8
21-11-2021,Alappuzha,4309,4161,148,21
21-11-2021,Kottayam,28848,28395,453,0
21-11-2021,Idukki,4258,4045,213,4
21-11-2021,Ernakulam,32600,32011,589,18
21-11-2021,Thrissur,15081,14834,247,39
21-11-2021,Palakkad,8036,7831,205,25
21-11-2021,Malappuram,12444,12242,202,15
21-11-2021,Kozhikode,18283,17937,346,5
21-11-2021,Wayanad,14971,14803,168,24
21-11-2021,Kannur,7612,7360,252,43
21-11-2021,Kasaragod,4962,4693,269,8
21-11-2021,total,192768,187604,5164,269
23-11-2021,Thiruvananthapuram,15747,14421,1326,35
23-11-2021,Kollam,15273,14964,309,39
23-11-2021,Pathanamthitta,7391,7007,384,8
23-11-2021,Alappuzha,4167,4019,148,14
23-11-2021,Kottayam,28096,27689,407,0
23-11-2021,Idukki,3543,3380,163,4
23-11-2021,Ernakulam,31362,30790,572,93
23-11-2021,Thrissur,13834,13577,257,62
23-11-2021,Palakkad,7970,7801,169,21
23-11-2021,Malappuram,11991,11746,245,14
23-11-2021,Kozhikode,18172,17797,375,25
23-11-2021,Wayanad,15109,14958,151,21
23-11-2021,Kannur,7267,6984,283,37
23-11-2021,Kasaragod,4659,4398,261,3
23-11-2021,total,184581,179531,5050,376
25-11-2021,Thiruvananthapuram,12789,11496,1293,41
25-11-2021,Kollam,14064,13783,281,33
25-11-2021,Pathanamthitta,7794,7434,360,5
25-11-2021,Alappuzha,3943,3834,109,12
25-11-2021,Kottayam,26007,25593,414,0
25-11-2021,Idukki,3539,3443,96,2
25-11-2021,Ernakulam,29635,29026,609,42
25-11-2021,Thrissur,13207,12959,248,34
25-11-2021,Palakkad,7900,7737,163,20
25-11-2021,Malappuram,11996,11769,227,10
25-11-2021,Kozhikode,17926,17596,330,20
25-11-2021,Wayanad,14224,14073,151,22
25-11-2021,Kannur,6819,6521,298,28
25-11-2021,Kasaragod,4476,4205,271,6
25-11-2021,total,174319,169469,4850,275
26-11-2021,Thiruvananthapuram,11546,10256,1290,32
26-11-2021,Kollam,13442,13171,271,31
26-11-2021,Pathanamthitta,7924,7572,352,9
26-11-2021,Alappuzha,3779,3666,113,14
26-11-2021,Kottayam,25418,25009,409,0
26-11-2021,Idukki,3362,3275,87,3
26-11-2021,Ernakulam,28309,27703,606,29
26-11-2021,Thrissur,12631,12392,239,40
26-11-2021,Palakkad,7924,7758,166,21
26-11-2021,Malappuram,11779,11530,249,20
26-11-2021,Kozhikode,17661,17367,294,12
26-11-2021,Wayanad,14550,14415,135,26
26-11-2021,Kannur,6763,6453,310,31
26-11-2021,Kasaragod,4259,3975,284,17
26-11-2021,total,169347,164542,4805,285
27-11-2021,Thiruvananthapuram,10059,8784,1275,33
27-11-2021,Kollam,12953,12677,276,51
27-11-2021,Pathanamthitta,7854,7502,352,5
27-11-2021,Alappuzha,3635,3533,102,10
27-11-2021,Kottayam,24681,24269,412,0
27-11-2021,Idukki,3276,3180,96,7
27-11-2021,Ernakulam,27859,27240,619,40
27-11-2021,Thrissur,12266,12037,229,40
27-11-2021,Palakkad,7889,7737,152,22
27-11-2021,Malappuram,11379,11148,231,13
27-11-2021,Kozhikode,17358,17047,311,18
27-11-2021,Wayanad,14062,13927,135,27
27-11-2021,Kannur,6773,6461,312,37
27-11-2021,Kasaragod,4044,3755,289,9
27-11-2021,total,164088,159297,4791,312
29-11-2021,Thiruvananthapuram,7042,5773,1269,30
29-11-2021,Kollam,12162,11870,292,41
29-11-2021,Pathanamthitta,7072,6710,362,4
29-11-2021,Alappuzha,3422,3324,98,10
29-11-2021,Kottayam,21578,21200,378,0
29-11-2021,Idukki,3033,2946,87,1
29-11-2021,Ernakulam,26896,26296,600,32
29-11-2021,Thrissur,11231,10980,251,32
29-11-2021,Palakkad,8084,7942,142,26
29-11-2021,Malappuram,11762,11547,215,18
29-11-2021,Kozhikode,20021,19708,313,9
29-11-2021,Wayanad,13906,13790,116,9
29-11-2021,Kannur,6836,6540,296,28
29-11-2021,Kasaragod,3741,3460,281,5
29-11-2021,total,156786,152086,4700,245
30-11-2021,Thiruvananthapuram,6271,5002,1269,30
30-11-2021,Kollam,11761,11474,287,34
30-11-2021,Pathanamthitta,6612,6248,364,10
30-11-2021,Alappuzha,3342,3236,106,15
30-11-2021,Kottayam,21601,21239,362,0
30-11-2021,Idukki,3065,2972,93,1
30-11-2021,Ernakulam,26162,25541,621,47
30-11-2021,Thrissur,10554,10322,232,32
30-11-2021,Palakkad,9051,8902,149,29
30-11-2021,Malappuram,11369,11146,223,10
30-11-2021,Kozhikode,19950,19640,310,21
30-11-2021,Wayanad,12874,12755,119,18
30-11-2021,Kannur,6889,6594,295,30
30-11-2021,Kasaragod,3720,3444,276,5
30-11-2021,total,153221,148515,4706,282
01-12-2021,Thiruvananthapuram,4801,3532,1269,30
01-12-2021,Kollam,11348,11057,291,39
01-12-2021,Pathanamthitta,6366,5998,368,7
01-12-2021,Alappuzha,3279,3179,100,14
01-12-2021,Kottayam,21428,21054,374,0
01-12-2021,Idukki,3008,2915,93,5
01-12-2021,Ernakulam,26156,25530,626,38
01-12-2021,Thrissur,9896,9666,230,26
01-12-2021,Palakkad,10037,9886,151,20
01-12-2021,Malappuram,11285,11062,223,16
01-12-2021,Kozhikode,19785,19476,309,10
01-12-2021,Wayanad,12389,12268,121,24
01-12-2021,Kannur,6948,6670,278,38
01-12-2021,Kasaragod,3709,3440,269,8
01-12-2021,total,150435,145733,4702,275
02-12-2021,Thiruvananthapuram,10410,9141,1269,36
02-12-2021,Kollam,10669,10347,322,40
02-12-2021,Pathanamthitta,5590,5223,367,8
02-12-2021,Alappuzha,3227,3138,89,6
02-12-2021,Kottayam,21550,21173,377,3
02-12-2021,Idukki,3069,2970,99,5
02-12-2021,Ernakulam,26444,25788,656,49
02-12-2021,Thrissur,9075,8840,235,48
02-12-2021,Palakkad,11017,10863,154,21
02-12-2021,Malappuram,11083,10860,223,19
02-12-2021,Kozhikode,19696,19389,307,14
02-12-2021,Wayanad,13213,13079,134,28
02-12-2021,Kannur,7013,6717,296,31
02-12-2021,Kasaragod,3583,3309,274,7
02-12-2021,total,155639,150837,4802,315
03-12-2021,Thiruvananthapuram,15837,14568,1269,30
03-12-2021,Kollam,9959,9666,293,21
03-12-2021,Pathanamthitta,4963,4602,361,7
03-12-2021,Alappuzha,3301,3217,84,12
03-12-2021,Kottayam,21648,21275,373,0
03-12-2021,Idukki,3144,3044,100,10
03-12-2021,Ernakulam,25673,25032,641,26
03-12-2021,Thrissur,8597,8372,225,37
03-12-2021,Palakkad,11646,11482,164,33
03-12-2021,Malappuram,11101,10888,213,12
03-12-2021,Kozhikode,20342,20054,288,9
03-12-2021,Wayanad,13221,13081,140,32
03-12-2021,Kannur,7055,6742,313,39
03-12-2021,Kasaragod,3412,3134,278,7
03-12-2021,total,159899,155157,4742,275
05-12-2021,Thiruvananthapuram,25258,23989,1269,38
05-12-2021,Kollam,9147,8821,326,32
05-12-2021,Pathanamthitta,4744,4383,361,3
05-12-2021,Alappuzha,3369,3292,77,11
05-12-2021,Kottayam,21648,21644,4,0
05-12-2021,Idukki,3423,3316,107,1
05-12-2021,Ernakulam,25477,24843,634,23
05-12-2021,Thrissur,7621,7402,219,34
05-12-2021,Palakkad,12182,12036,146,23
05-12-2021,Malappuram,10958,10736,222,17
05-12-2021,Kozhikode,20429,20138,291,20
05-12-2021,Wayanad,12625,12495,130,14
05-12-2021,Kannur,7520,7228,292,30
05-12-2021,Kasaragod,3292,3000,292,10
05-12-2021,total,167693,163323,4370,256
07-12-2021,Thiruvananthapuram,30123,28854,1269,30
07-12-2021,Kollam,9356,9046,310,42
07-12-2021,Pathanamthitta,3939,3551,388,6
07-12-2021,Alappuzha,3310,3248,62,8
07-12-2021,Kottayam,19823,19442,381,2
07-12-2021,Idukki,3439,3339,100,4
07-12-2021,Ernakulam,24978,24373,605,34
07-12-2021,Thrissur,5896,5674,222,34
07-12-2021,Palakkad,12834,12683,151,23
07-12-2021,Malappuram,10946,10716,230,13
07-12-2021,Kozhikode,17060,16770,290,15
07-12-2021,Wayanad,11721,11583,138,14
07-12-2021,Kannur,7622,7318,304,43
07-12-2021,Kasaragod,3603,3339,264,3
07-12-2021,total,164650,159936,4714,271
09-12-2021,Thiruvananthapuram,29759,28490,1269,30
09-12-2021,Kollam,9265,8963,302,47
09-12-2021,Pathanamthitta,3647,3235,412,10
09-12-2021,Alappuzha,3405,3345,60,11
09-12-2021,Kottayam,20413,20035,378,12
09-12-2021,Idukki,2999,2901,98,7
09-12-2021,Ernakulam,24381,23795,586,19
09-12-2021,Thrissur,5138,4936,202,30
09-12-2021,Palakkad,13667,13526,141,20
09-12-2021,Malappuram,11025,10832,193,17
09-12-2021,Kozhikode,17150,16861,289,15
09-12-2021,Wayanad,10892,10770,122,24
09-12-2021,Kannur,7790,7489,301,29
09-12-2021,Kasaragod,3967,3719,248,6
09-12-2021,total,163498,158897,4601,277
08-12-2021,Thiruvananthapuram,30437,29168,1269,30
08-12-2021,Kollam,9472,9155,317,24
08-12-2021,Pathanamthitta,3739,3346,393,9
08-12-2021,Alappuzha,3319,3259,60,6
08-12-2021,Kottayam,19939,19550,389,9
08-12-2021,Idukki,3119,3029,90,8
08-12-2021,Ernakulam,24378,23791,587,20
08-12-2021,Thrissur,5496,5287,209,45
08-12-2021,Palakkad,13163,13019,144,13
08-12-2021,Malappuram,11066,10819,247,16
08-12-2021,Kozhikode,17134,16851,283,27
08-12-2021,Wayanad,10876,10751,125,14
08-12-2021,Kannur,7710,7401,309,33
08-12-2021,Kasaragod,3834,3564,270,7
08-12-2021,total,163682,158990,4692,261
06-12-2021,Thiruvananthapuram,30693,29424,1269,30
06-12-2021,Kollam,9465,9133,332,38
06-12-2021,Pathanamthitta,4306,3935,371,6
06-12-2021,Alappuzha,3285,3222,63,8
06-12-2021,Kottayam,20607,20237,370,1
06-12-2021,Idukki,3273,3166,107,4
06-12-2021,Ernakulam,25031,24402,629,12
06-12-2021,Thrissur,6824,6581,243,44
06-12-2021,Palakkad,12381,12238,143,20
06-12-2021,Malappuram,11087,10855,232,14
06-12-2021,Kozhikode,17194,16921,273,14
06-12-2021,Wayanad,11774,11641,133,20
06-12-2021,Kannur,7571,7275,296,39
06-12-2021,Kasaragod,3296,2999,297,5
06-12-2021,total,166787,162029,4758,255
04-12-2021,Thiruvananthapuram,21190,19921,1269,30
04-12-2021,Kollam,9543,9218,325,45
04-12-2021,Pathanamthitta,5011,4648,363,4
04-12-2021,Alappuzha,3295,3220,75,8
04-12-2021,Kottayam,21648,21648,,
04-12-2021,Idukki,3313,3207,106,2
04-12-2021,Ernakulam,25312,24657,655,46
04-12-2021,Thrissur,7965,7734,231,35
04-12-2021,Palakkad,11913,11759,154,25
04-12-2021,Malappuram,10946,10729,217,15
04-12-2021,Kozhikode,20433,20128,305,18
04-12-2021,Wayanad,13249,13116,133,22
04-12-2021,Kannur,7462,7168,294,40
04-12-2021,Kasaragod,3467,3180,287,9
04-12-2021,total,164747,160333,4414,299
24-11-2021,Thiruvananthapuram,14477,13179,1298,35
24-11-2021,Kollam,14919,14611,308,32
24-11-2021,Pathanamthitta,7533,7140,393,11
24-11-2021,Alappuzha,4059,3934,125,14
24-11-2021,Kottayam,27717,27314,403,0
24-11-2021,Idukki,3696,3551,145,3
24-11-2021,Ernakulam,30024,29447,577,33
24-11-2021,Thrissur,13692,13426,266,51
24-11-2021,Palakkad,7921,7757,164,18
24-11-2021,Malappuram,11834,11616,218,12
24-11-2021,Kozhikode,18043,17711,332,18
24-11-2021,Wayanad,14893,14736,157,31
24-11-2021,Kannur,7011,6711,300,38
24-11-2021,Kasaragod,4497,4228,269,9
24-11-2021,total,180316,175361,4955,305
22-11-2021,Thiruvananthapuram,17240,15900,1340,47
22-11-2021,Kollam,16030,15697,333,44
22-11-2021,Pathanamthitta,7200,6809,391,8
22-11-2021,Alappuzha,4210,4063,147,15
22-11-2021,Kottayam,28117,27691,426,0
22-11-2021,Idukki,3905,3739,166,0
22-11-2021,Ernakulam,31689,31107,582,25
22-11-2021,Thrissur,14622,14381,241,52
22-11-2021,Palakkad,7904,7706,198,24
22-11-2021,Malappuram,12429,12227,202,14
22-11-2021,Kozhikode,18232,17876,356,28
22-11-2021,Wayanad,15395,15242,153,16
22-11-2021,Kannur,7394,7157,237,48
22-11-2021,Kasaragod,4612,4334,278,12
22-11-2021,total,188979,183929,5050,333
20-11-2021,Thiruvananthapuram,21474,20128,1346,45
20-11-2021,Kollam,16989,16652,337,32
20-11-2021,Pathanamthitta,5490,5101,389,11
20-11-2021,Alappuzha,4449,4300,149,32
20-11-2021,Kottayam,29058,28608,450,0
20-11-2021,Idukki,4311,4108,203,3
20-11-2021,Ernakulam,33298,32713,585,11
20-11-2021,Thrissur,15678,15434,244,35
20-11-2021,Palakkad,8322,8110,212,15
20-11-2021,Malappuram,12743,12541,202,16
20-11-2021,Kozhikode,18424,18073,351,23
20-11-2021,Wayanad,14620,14452,168,28
20-11-2021,Kannur,7681,7417,264,45
20-11-2021,Kasaragod,317,55,262,6
20-11-2021,total,192854,187692,5162,302
19-11-2021,Thiruvananthapuram,23087,21733,1354,54
19-11-2021,Kollam,17594,17249,345,39
19-11-2021,Pathanamthitta,5236,4863,373,12
19-11-2021,Alappuzha,4571,4433,138,10
19-11-2021,Kottayam,29366,28913,453,0
19-11-2021,Idukki,4380,4180,200,12
19-11-2021,Ernakulam,33749,33163,586,42
19-11-2021,Thrissur,15728,15460,268,41
19-11-2021,Palakkad,8180,7977,203,27
19-11-2021,Malappuram,12402,12203,199,19
19-11-2021,Kozhikode,22245,21878,367,26
19-11-2021,Wayanad,14781,14612,169,46
19-11-2021,Kannur,7713,7438,275,39
19-11-2021,Kasaragod,5234,4942,292,3
19-11-2021,total,204266,199044,5222,370
18-11-2021,Thiruvananthapuram,24792,23451,1341,43
18-11-2021,Kollam,17980,17612,368,57
18-11-2021,Pathanamthitta,5114,4728,386,7
18-11-2021,Alappuzha,4721,4578,143,12
18-11-2021,Kottayam,29404,28954,450,0
18-11-2021,Idukki,4593,4410,183,9
18-11-2021,Ernakulam,33766,33192,574,23
18-11-2021,Thrissur,15951,15675,276,41
18-11-2021,Palakkad,8119,7945,174,23
18-11-2021,Malappuram,12317,12095,222,17
18-11-2021,Kozhikode,22344,21980,364,19
18-11-2021,Wayanad,13772,13626,146,16
18-11-2021,Kannur,7692,7440,252,49
18-11-2021,Kasaragod,5257,4949,308,6
18-11-2021,total,205822,200635,5187,322
15-11-2021,Thiruvananthapuram,29996,28641,1355,62
15-11-2021,Kollam,18193,17801,392,55
15-11-2021,Pathanamthitta,6064,5666,398,15
15-11-2021,Alappuzha,9111,8966,145,17
15-11-2021,Kottayam,29984,29525,459,0
15-11-2021,Idukki,5243,5063,180,1
15-11-2021,Ernakulam,33967,33346,621,12
15-11-2021,Thrissur,16214,15902,312,40
15-11-2021,Palakkad,7968,7776,192,19
15-11-2021,Malappuram,13056,12823,233,16
15-11-2021,Kozhikode,26606,26218,388,13
15-11-2021,Wayanad,13788,13651,137,29
15-11-2021,Kannur,7146,6906,240,38
15-11-2021,Kasaragod,5130,4799,331,8
15-11-2021,total,222466,217083,5383,325
14-11-2021,Thiruvananthapuram,31610,30221,1389,62
14-11-2021,Kollam,18929,18558,371,47
14-11-2021,Pathanamthitta,7211,6816,395,8
14-11-2021,Alappuzha,9117,8974,143,23
14-11-2021,Kottayam,28832,28377,455,0
14-11-2021,Idukki,5433,5238,195,5
14-11-2021,Ernakulam,34659,34009,650,36
14-11-2021,Thrissur,16261,15949,312,43
14-11-2021,Palakkad,7995,7797,198,28
14-11-2021,Malappuram,13526,13256,270,16
14-11-2021,Kozhikode,27111,26688,423,15
14-11-2021,Wayanad,13369,13246,123,24
14-11-2021,Kannur,7125,6878,247,41
14-11-2021,Kasaragod,5464,5132,332,14
14-11-2021,total,226642,221139,5503,362
10-11-2021,Thiruvananthapuram,35371,34001,1370,56
10-11-2021,Kollam,19465,19061,404,63
10-11-2021,Pathanamthitta,10285,9890,395,14
10-11-2021,Alappuzha,4950,4811,139,18
10-11-2021,Kottayam,25225,24730,495,7
10-11-2021,Idukki,5286,4995,291,14
10-11-2021,Ernakulam,35606,34913,693,60
10-11-2021,Thrissur,15443,15140,303,56
10-11-2021,Palakkad,8343,8141,202,27
10-11-2021,Malappuram,14614,14326,288,11
10-11-2021,Kozhikode,24040,23592,448,18
10-11-2021,Wayanad,9790,9651,139,16
10-11-2021,Kannur,6772,6555,217,26
10-11-2021,Kasaragod,6543,6240,303,14
10-11-2021,total,221733,216046,5687,400
09-11-2021,Thiruvananthapuram,37267,35885,1382,89
09-11-2021,Kollam,20135,19744,391,48
09-11-2021,Pathanamthitta,10730,10340,390,15
09-11-2021,Alappuzha,4856,4715,141,22
09-11-2021,Kottayam,25126,24625,501,13
09-11-2021,Idukki,5784,5508,276,4
09-11-2021,Ernakulam,36705,35999,706,26
09-11-2021,Thrissur,14882,14580,302,56
09-11-2021,Palakkad,8153,7944,209,20
09-11-2021,Malappuram,15711,15398,313,14
09-11-2021,Kozhikode,25371,24880,491,15
09-11-2021,Wayanad,9680,9540,140,41
09-11-2021,Kannur,6589,6382,207,38
09-11-2021,Kasaragod,6743,6455,288,11
09-11-2021,total,227732,221995,5737,412
08-11-2021,Thiruvananthapuram,38253,36877,1376,30
08-11-2021,Kollam,20059,19646,413,42
08-11-2021,Pathanamthitta,10540,10156,384,8
08-11-2021,Alappuzha,5135,4985,150,23
08-11-2021,Kottayam,24885,24386,499,5
08-11-2021,Idukki,5798,5517,281,6
08-11-2021,Ernakulam,36999,36267,732,13
08-11-2021,Thrissur,14773,14458,315,58
08-11-2021,Palakkad,8091,7894,197,22
08-11-2021,Malappuram,16694,16332,362,17
08-11-2021,Kozhikode,26765,26237,528,33
08-11-2021,Wayanad,9155,9032,123,17
08-11-2021,Kannur,6917,6701,216,38
08-11-2021,Kasaragod,6839,6530,309,6
08-11-2021,total,230903,225018,5885,318
01-11-2021,Thiruvananthapuram,51058,51058,,
01-11-2021,Kollam,21140,20592,548,54
01-11-2021,Pathanamthitta,9790,9351,439,20
01-11-2021,Alappuzha,6392,6176,216,20
01-11-2021,Kottayam,24064,23440,624,5
01-11-2021,Idukki,6444,6182,262,11
01-11-2021,Ernakulam,42381,41512,869,16
01-11-2021,Thrissur,13737,13344,393,46
01-11-2021,Palakkad,10096,9778,318,
01-11-2021,Malappuram,21667,21266,401,
01-11-2021,Kozhikode,32643,31935,708,33
01-11-2021,Wayanad,7777,7628,149,
01-11-2021,Kannur,12056,11759,297,
01-11-2021,Kasaragod,8557,8253,304,8
01-11-2021,total,267802,262274,5528,213
18-10-2021,Thiruvananthapuram,45338,43070,2268,106
18-10-2021,Kollam,18936,18331,605,71
18-10-2021,Pathanamthitta,10926,10427,499,31
18-10-2021,Alappuzha,9886,9362,524,54
18-10-2021,Kottayam,33430,32707,723,9
18-10-2021,Idukki,8608,8284,324,10
18-10-2021,Ernakulam,33544,32132,1412,55
18-10-2021,Thrissur,23434,22775,659,95
18-10-2021,Palakkad,15622,15091,531,45
18-10-2021,Malappuram,26709,26049,660,26
18-10-2021,Kozhikode,38721,37763,958,58
18-10-2021,Wayanad,9091,8901,190,11
18-10-2021,Kannur,18339,17975,364,37
18-10-2021,Kasaragod,10234,9869,365,26
18-10-2021,total,302818,292736,10082,634
16-10-2021,Thiruvananthapuram,47742,45430,2312,113
16-10-2021,Kollam,20512,19897,615,55
16-10-2021,Pathanamthitta,10912,10366,546,21
16-10-2021,Alappuzha,10168,9642,526,64
16-10-2021,Kottayam,35150,34364,786,20
16-10-2021,Idukki,8526,8221,305,7
16-10-2021,Ernakulam,31746,30356,1390,59
16-10-2021,Thrissur,25847,25101,746,155
16-10-2021,Palakkad,16368,15732,636,51
16-10-2021,Malappuram,30488,29794,694,31
16-10-2021,Kozhikode,37516,36626,890,42
16-10-2021,Wayanad,9785,9553,232,45
16-10-2021,Kannur,19539,19148,391,34
16-10-2021,Kasaragod,10341,9940,335,16
16-10-2021,total,314640,304170,10404,713
12-10-2021,Thiruvananthapuram,51585,49004,2581,158
12-10-2021,Kollam,24809,24059,750,74
12-10-2021,Pathanamthitta,10486,9836,650,18
12-10-2021,Alappuzha,12561,11935,626,37
12-10-2021,Kottayam,37551,36636,915,18
12-10-2021,Idukki,8221,7820,401,12
12-10-2021,Ernakulam,28205,26638,1567,83
12-10-2021,Thrissur,27180,26373,807,132
12-10-2021,Palakkad,20037,19369,668,73
12-10-2021,Malappuram,36820,36031,789,25
12-10-2021,Kozhikode,42171,41133,1038,37
12-10-2021,Wayanad,12209,11912,297,36
12-10-2021,Kannur,21580,21169,411,34
12-10-2021,Kasaragod,9667,9328,339,15
12-10-2021,total,343082,331243,11839,752
08-10-2021,Thiruvananthapuram,47010,43851,3159,155
08-10-2021,Kollam,31019,30099,920,93
08-10-2021,Pathanamthitta,12747,12032,715,40
08-10-2021,Alappuzha,16667,15894,773,49
08-10-2021,Kottayam,42405,41241,1164,42
08-10-2021,Idukki,8167,7724,443,22
08-10-2021,Ernakulam,34740,33036,1704,63
08-10-2021,Thrissur,24311,23356,955,149
08-10-2021,Palakkad,23997,23242,755,88
08-10-2021,Malappuram,39771,38930,841,28
08-10-2021,Kozhikode,46216,44816,1400,93
08-10-2021,Wayanad,13609,13139,470,21
08-10-2021,Kannur,19745,19266,479,36
08-10-2021,Kasaragod,10792,10273,357,13
08-10-2021,total,371196,356899,14135,892
05-10-2021,Thiruvananthapuram,40284,36590,3694,253
05-10-2021,Kollam,42994,41853,1141,103
05-10-2021,Pathanamthitta,11805,10944,861,57
05-10-2021,Alappuzha,17092,16216,876,98
05-10-2021,Kottayam,50632,49275,1357,35
05-10-2021,Idukki,8133,7708,425,16
05-10-2021,Ernakulam,38214,36417,1797,55
05-10-2021,Thrissur,26073,24916,1157,165
05-10-2021,Palakkad,30305,29455,850,75
05-10-2021,Malappuram,41437,40548,889,32
05-10-2021,Kozhikode,51007,49656,1351,111
05-10-2021,Wayanad,14903,14325,578,38
05-10-2021,Kannur,19875,19400,475,81
05-10-2021,Kasaragod,10387,10050,337,9
05-10-2021,total,403141,387353,15788,1128
25-09-2021,Thiruvananthapuram,39879,35744,4135,295
25-09-2021,Kollam,33929,32267,1662,220
25-09-2021,Pathanamthitta,13151,11991,1160,57
25-09-2021,Alappuzha,20064,18582,1482,135
25-09-2021,Kottayam,56405,54485,1920,98
25-09-2021,Idukki,11799,11185,614,16
25-09-2021,Ernakulam,39959,37585,2374,74
25-09-2021,Thrissur,56179,54109,2070,247
25-09-2021,Palakkad,50308,48945,1363,248
25-09-2021,Malappuram,48368,47172,1196,59
25-09-2021,Kozhikode,49305,47627,1678,151
25-09-2021,Wayanad,17103,15890,1213,132
25-09-2021,Kannur,24607,23962,645,64
25-09-2021,Kasaragod,12864,12349,515,29
25-09-2021,total,473920,451893,22027,1825
18-09-2021,Thiruvananthapuram,42311,38000,4311,268
18-09-2021,Kollam,27477,25397,2080,230
18-09-2021,Pathanamthitta,13296,12058,1238,77
18-09-2021,Alappuzha,22917,21060,1857,178
18-09-2021,Kottayam,52491,50080,2411,90
18-09-2021,Idukki,11072,10380,692,27
18-09-2021,Ernakulam,38343,35593,2750,57
18-09-2021,Thrissur,59213,56913,2300,272
18-09-2021,Palakkad,62017,60045,1972,277
18-09-2021,Malappuram,56466,55125,1341,109
18-09-2021,Kozhikode,73505,71370,2135,151
18-09-2021,Wayanad,23201,21815,1386,74
18-09-2021,Kannur,30177,29372,805,84
18-09-2021,Kasaragod,15597,14981,616,26
18-09-2021,total,528083,502189,25894,1920
16-09-2021,Thiruvananthapuram,44327,40023,4304,346
16-09-2021,Kollam,31369,29080,2289,276
16-09-2021,Pathanamthitta,13780,12491,1289,54
16-09-2021,Alappuzha,25905,23891,2014,205
16-09-2021,Kottayam,51768,49255,2513,102
16-09-2021,Idukki,11377,10633,744,33
16-09-2021,Ernakulam,40853,37983,2870,73
16-09-2021,Thrissur,59630,57264,2366,220
16-09-2021,Palakkad,63530,61472,2058,159
16-09-2021,Malappuram,58233,56920,1313,99
16-09-2021,Kozhikode,83710,81389,2321,116
16-09-2021,Wayanad,23576,22150,1426,96
16-09-2021,Kannur,31016,30165,851,81
16-09-2021,Kasaragod,15733,15075,658,21
16-09-2021,total,554807,527791,27016,1881
14-09-2021,Thiruvananthapuram,43268,38732,4536,328
14-09-2021,Kollam,31184,28552,2632,224
14-09-2021,Pathanamthitta,16174,14700,1474,44
14-09-2021,Alappuzha,24968,22759,2209,139
14-09-2021,Kottayam,51488,48944,2544,85
14-09-2021,Idukki,12445,11700,745,33
14-09-2021,Ernakulam,43960,40882,3078,104
14-09-2021,Thrissur,60940,58332,2608,236
14-09-2021,Palakkad,68342,66168,2174,183
14-09-2021,Malappuram,60362,58974,1388,125
14-09-2021,Kozhikode,87981,85557,2424,133
14-09-2021,Wayanad,25698,24183,1515,90
14-09-2021,Kannur,32057,31134,923,87
14-09-2021,Kasaragod,16801,16174,627,12
14-09-2021,total,575668,546791,28877,1823
09-09-2021,Thiruvananthapuram,43172,38461,4711,315
09-09-2021,Kollam,32653,29426,3227,318
09-09-2021,Pathanamthitta,18382,16450,1932,121
09-09-2021,Alappuzha,28167,25530,2637,207
09-09-2021,Kottayam,50855,47993,2862,173
09-09-2021,Idukki,13601,12824,777,23
09-09-2021,Ernakulam,48733,45187,3546,111
09-09-2021,Thrissur,62286,59380,2906,345
09-09-2021,Palakkad,61898,59286,2612,228
09-09-2021,Malappuram,68762,67256,1506,169
09-09-2021,Kozhikode,99609,96901,2708,176
09-09-2021,Wayanad,26817,25156,1661,136
09-09-2021,Kannur,34003,33056,947,102
09-09-2021,Kasaragod,19512,18825,687,42
09-09-2021,total,608450,575731,32719,2466
06-09-2021,Thiruvananthapuram,43398,38772,4626,317
06-09-2021,Kollam,34096,30843,3253,325
06-09-2021,Pathanamthitta,20002,18034,1968,99
06-09-2021,Alappuzha,28648,25962,2686,206
06-09-2021,Kottayam,54214,51385,2829,130
06-09-2021,Idukki,13400,12595,805,16
06-09-2021,Ernakulam,46850,43157,3693,81
06-09-2021,Thrissur,59309,56440,2869,425
06-09-2021,Palakkad,53831,51081,2750,233
06-09-2021,Malappuram,76141,74587,1554,184
06-09-2021,Kozhikode,110078,107225,2853,238
06-09-2021,Wayanad,26885,25253,1632,99
06-09-2021,Kannur,34066,33092,974,90
06-09-2021,Kasaragod,19821,19156,665,20
06-09-2021,total,620739,587582,33157,2463
02-09-2021,Thiruvananthapuram,35205,30706,4499,417
02-09-2021,Kollam,27919,24720,3199,448
02-09-2021,Pathanamthitta,17496,15429,2067,138
02-09-2021,Alappuzha,23982,21330,2652,322
02-09-2021,Kottayam,49049,46045,3004,181
02-09-2021,Idukki,15665,14835,830,36
02-09-2021,Ernakulam,46319,42533,3786,122
02-09-2021,Thrissur,57596,54850,2746,436
02-09-2021,Palakkad,40903,38137,2766,262
02-09-2021,Malappuram,76508,74874,1634,185
02-09-2021,Kozhikode,101073,98201,2872,277
02-09-2021,Wayanad,23324,21643,1681,157
02-09-2021,Kannur,34041,33101,940,109
02-09-2021,Kasaragod,19007,18401,606,22
02-09-2021,total,568087,534805,33282,3112
23-08-2021,Thiruvananthapuram,27363,23722,3641,175
23-08-2021,Kollam,21970,19831,2139,211
23-08-2021,Pathanamthitta,11659,10273,1386,35
23-08-2021,Alappuzha,19172,17301,1871,86
23-08-2021,Kottayam,39553,37587,1966,33
23-08-2021,Idukki,10792,10047,745,10
23-08-2021,Ernakulam,39426,36392,3034,60
23-08-2021,Thrissur,50115,47823,2292,363
23-08-2021,Palakkad,34189,31859,2330,153
23-08-2021,Malappuram,74549,72897,1652,222
23-08-2021,Kozhikode,76075,73555,2520,114
23-08-2021,Wayanad,16561,15248,1313,60
23-08-2021,Kannur,31601,30667,934,92
23-08-2021,Kasaragod,18896,18140,756,33
23-08-2021,total,471921,445342,26579,1647
24-08-2021,Thiruvananthapuram,27164,23548,3616,300
24-08-2021,Kollam,21887,19748,2139,295
24-08-2021,Pathanamthitta,11608,10247,1361,33
24-08-2021,Alappuzha,18876,17071,1805,81
24-08-2021,Kottayam,39370,37372,1998,73
24-08-2021,Idukki,11054,10328,726,18
24-08-2021,Ernakulam,39427,36344,3083,145
24-08-2021,Thrissur,49091,46998,2093,307
24-08-2021,Palakkad,35912,33636,2276,202
24-08-2021,Malappuram,73005,71416,1589,201
24-08-2021,Kozhikode,74661,72124,2537,151
24-08-2021,Wayanad,16133,14936,1197,116
24-08-2021,Kannur,30675,29708,967,132
24-08-2021,Kasaragod,18188,17536,652,24
24-08-2021,total,467051,441012,26039,2078
11-08-2021,Thiruvananthapuram,33274,29400,3874,232
11-08-2021,Kollam,31305,28841,2464,250
11-08-2021,Pathanamthitta,11152,9523,1629,116
11-08-2021,Alappuzha,20544,18312,2232,199
11-08-2021,Kottayam,40775,38514,2261,192
11-08-2021,Idukki,8683,8072,611,42
11-08-2021,Ernakulam,42628,39175,3453,88
11-08-2021,Thrissur,52979,51264,1715,281
11-08-2021,Palakkad,37221,34486,2735,226
11-08-2021,Malappuram,70125,68258,1867,279
11-08-2021,Kozhikode,59796,57373,2423,263
11-08-2021,Wayanad,18727,17239,1488,97
11-08-2021,Kannur,30629,29767,862,70
11-08-2021,Kasaragod,27642,26767,875,36
11-08-2021,total,485480,456991,28489,2371
07-08-2021,Thiruvananthapuram,32560,28659,3901,202
07-08-2021,Kollam,33170,30574,2596,278
07-08-2021,Pathanamthitta,11174,9492,1682,107
07-08-2021,Alappuzha,21266,19082,2184,155
07-08-2021,Kottayam,40528,38177,2351,119
07-08-2021,Idukki,7907,7297,610,27
07-08-2021,Ernakulam,43308,39722,3586,188
07-08-2021,Thrissur,51600,49838,1762,338
07-08-2021,Palakkad,37434,34993,2441,224
07-08-2021,Malappuram,76628,74656,1972,315
07-08-2021,Kozhikode,58950,56309,2641,242
07-08-2021,Wayanad,18345,16797,1548,123
07-08-2021,Kannur,29406,28531,875,112
07-08-2021,Kasaragod,29215,28284,931,80
07-08-2021,total,491491,462411,29080,2510
05-08-2021,Thiruvananthapuram,32356,28522,3834,197
05-08-2021,Kollam,32251,29596,2655,288
05-08-2021,Pathanamthitta,11553,9885,1668,131
05-08-2021,Alappuzha,22292,20130,2162,105
05-08-2021,Kottayam,40550,38077,2473,183
05-08-2021,Idukki,7505,6900,605,32
05-08-2021,Ernakulam,45267,41654,3613,141
05-08-2021,Thrissur,50224,48617,1607,375
05-08-2021,Palakkad,38523,35779,2744,275
05-08-2021,Malappuram,70714,68682,2032,333
05-08-2021,Kozhikode,56194,53607,2587,249
05-08-2021,Wayanad,16878,15374,1504,111
05-08-2021,Kannur,28944,28086,858,123
05-08-2021,Kasaragod,27906,26890,1016,64
05-08-2021,total,481157,451799,29358,2607
03-08-2021,Thiruvananthapuram,32194,28224,3970,255
03-08-2021,Kollam,32485,29826,2659,317
03-08-2021,Pathanamthitta,12020,10500,1520,45
03-08-2021,Alappuzha,22579,20485,2094,119
03-08-2021,Kottayam,37655,35252,2403,63
03-08-2021,Idukki,7455,6909,546,16
03-08-2021,Ernakulam,45461,41877,3584,155
03-08-2021,Thrissur,46369,44677,1692,404
03-08-2021,Palakkad,39423,36809,2614,306
03-08-2021,Malappuram,66417,64514,1903,310
03-08-2021,Kozhikode,52839,50226,2613,233
03-08-2021,Wayanad,16006,14561,1445,113
03-08-2021,Kannur,28183,27369,814,73
03-08-2021,Kasaragod,27068,26067,1001,47
03-08-2021,total,466154,437296,28858,2456
21-07-2021,Thiruvananthapuram,31395,27213,4182,202
21-07-2021,Kollam,28872,26423,2449,316
21-07-2021,Pathanamthitta,9267,7896,1371,125
21-07-2021,Alappuzha,28244,26358,1886,199
21-07-2021,Kottayam,28950,26988,1962,165
21-07-2021,Idukki,6551,5908,643,24
21-07-2021,Ernakulam,41860,38802,3058,119
21-07-2021,Thrissur,32431,31145,1286,268
21-07-2021,Palakkad,33347,31751,1596,445
21-07-2021,Malappuram,53582,51897,1685,63
21-07-2021,Kozhikode,44447,42448,1999,215
21-07-2021,Wayanad,14079,12886,1193,100
21-07-2021,Kannur,23304,22549,755,85
21-07-2021,Kasaragod,30041,29052,989,75
21-07-2021,total,406370,381316,25054,2401
17-07-2021,Thiruvananthapuram,31727,27506,4221,184
17-07-2021,Kollam,31290,28813,2477,278
17-07-2021,Pathanamthitta,9148,7867,1281,83
17-07-2021,Alappuzha,27834,25920,1914,234
17-07-2021,Kottayam,25511,23616,1895,92
17-07-2021,Idukki,10839,10194,645,19
17-07-2021,Ernakulam,39588,36572,3016,95
17-07-2021,Thrissur,34826,33545,1281,268
17-07-2021,Palakkad,31933,30271,1662,385
17-07-2021,Malappuram,52131,50469,1662,83
17-07-2021,Kozhikode,42588,40607,1981,186
17-07-2021,Wayanad,13587,12459,1128,47
17-07-2021,Kannur,19662,18861,801,81
17-07-2021,Kasaragod,28970,28122,848,44
17-07-2021,total,399634,374822,24812,2079
02-07-2021,Thiruvananthapuram,37084,32242,2948,332
02-07-2021,Kollam,30537,27889,3670,231
02-07-2021,Pathanamthitta,10241,8696,512,83
02-07-2021,Alappuzha,21743,20208,2041,140
02-07-2021,Kottayam,24670,23079,1250,68
02-07-2021,Idukki,15983,15400,450,41
02-07-2021,Ernakulam,39555,36876,2122,95
02-07-2021,Thrissur,62042,60663,1856,232
02-07-2021,Palakkad,35821,33845,2172,301
02-07-2021,Malappuram,32842,31454,2975,64
02-07-2021,Kozhikode,32056,30215,2013,195
02-07-2021,Wayanad,11556,10626,568,56
02-07-2021,Kannur,14283,13508,756,86
02-07-2021,Kasaragod,23340,22550,780,64
02-07-2021,total,391753,367251,24113,1988
16-06-2021,Thiruvananthapuram,49536,44152,5384,427
16-06-2021,Kollam,33220,30253,2967,339
16-06-2021,Pathanamthitta,22921,21403,1518,129
16-06-2021,Alappuzha,29210,27411,1799,140
16-06-2021,Kottayam,31405,29709,1696,31
16-06-2021,Idukki,22586,21340,1246,24
16-06-2021,Ernakulam,42588,39055,3533,179
16-06-2021,Thrissur,85375,83801,1574,271
16-06-2021,Palakkad,58062,55218,2844,140
16-06-2021,Malappuram,37900,36068,1832,76
16-06-2021,Kozhikode,33618,31498,2120,152
16-06-2021,Wayanad,10490,9381,1109,41
16-06-2021,Kannur,14661,13832,829,80
16-06-2021,Kasaragod,20768,20207,561,23
16-06-2021,total,492340,463328,29012,2052
18-05-2021,Thiruvananthapuram,94343,88551,5792,666
18-05-2021,Kollam,52104,48767,3337,575
18-05-2021,Pathanamthitta,28263,26644,1619,35
18-05-2021,Alappuzha,66463,63891,2572,332
18-05-2021,Kottayam,61811,58217,3594,81
18-05-2021,Idukki,29794,28938,856,27
18-05-2021,Ernakulam,112914,108017,4897,447
18-05-2021,Thrissur,146634,143676,2958,1628
18-05-2021,Palakkad,108076,105339,2737,324
18-05-2021,Malappuram,68002,65416,2586,373
18-05-2021,Kozhikode,109665,106106,3559,285
18-05-2021,Wayanad,27966,26746,1220,126
18-05-2021,Kannur,72735,71213,1522,293
18-05-2021,Kasaragod,32225,31500,725,33
18-05-2021,total,1010995,973021,37974,5225
04-05-2021,Thiruvananthapuram,78868,74886,3982,443
04-05-2021,Kollam,27029,25557,1472,256
04-05-2021,Pathanamthitta,12474,10991,1483,154
04-05-2021,Alappuzha,40176,38200,1976,164
04-05-2021,Kottayam,61702,58859,2843,29
04-05-2021,Idukki,17640,17053,587,17
04-05-2021,Ernakulam,102101,98370,3731,325
04-05-2021,Thrissur,87395,84612,2783,490
04-05-2021,Palakkad,56745,54711,2034,483
04-05-2021,Malappuram,60304,58598,1706,307
04-05-2021,Kozhikode,114431,111412,3019,323
04-05-2021,Wayanad,29793,29053,740,137
04-05-2021,Kannur,55401,54264,1137,108
04-05-2021,Kasaragod,15685,15063,622,17
04-05-2021,total,759744,731629,28115,3253
30-04-2021,Thiruvananthapuram,67986,64740,3246,661
30-04-2021,Kollam,23718,22425,1293,232
30-04-2021,Pathanamthitta,11640,10191,1449,188
30-04-2021,Alappuzha,34567,32837,1730,152
30-04-2021,Kottayam,58049,56099,1950,1798
30-04-2021,Idukki,14688,14083,605,52
30-04-2021,Ernakulam,99398,96355,3043,525
30-04-2021,Thrissur,68085,65564,2521,397
30-04-2021,Palakkad,38984,37467,1517,181
30-04-2021,Malappuram,42298,40927,1371,425
30-04-2021,Kozhikode,97188,94418,2770,321
30-04-2021,Wayanad,25691,25002,689,115
30-04-2021,Kannur,48873,47868,1005,116
30-04-2021,Kasaragod,12364,11727,637,43
30-04-2021,total,643529,619703,23826,5206
29-04-2021,Thiruvananthapuram,63569,60565,3004,420
29-04-2021,Kollam,22094,20858,1236,185
29-04-2021,Pathanamthitta,10895,9391,1504,162
29-04-2021,Alappuzha,32422,30636,1786,253
29-04-2021,Kottayam,54961,52637,2324,1146
29-04-2021,Idukki,13755,13132,623,79
29-04-2021,Ernakulam,94100,91265,2835,224
29-04-2021,Thrissur,61972,59485,2487,380
29-04-2021,Palakkad,35632,33989,1643,334
29-04-2021,Malappuram,33534,31992,1542,511
29-04-2021,Kozhikode,89346,86630,2716,391
29-04-2021,Wayanad,23731,23037,694,149
29-04-2021,Kannur,45991,45031,960,155
29-04-2021,Kasaragod,11838,11183,655,34
29-04-2021,total,593840,569831,24009,4423
28-04-2021,Thiruvananthapuram,59288,56429,2859,424
28-04-2021,Kollam,21062,19898,1164,190
28-04-2021,Pathanamthitta,10233,8809,1424,115
28-04-2021,Alappuzha,30481,28799,1682,240
28-04-2021,Kottayam,51810,49558,2252,1441
28-04-2021,Idukki,12810,12224,586,45
28-04-2021,Ernakulam,87821,85124,2697,211
28-04-2021,Thrissur,55547,53109,2438,469
28-04-2021,Palakkad,32618,31247,1371,168
28-04-2021,Malappuram,28258,26870,1388,511
28-04-2021,Kozhikode,82764,80181,2583,361
28-04-2021,Wayanad,22121,21502,619,89
28-04-2021,Kannur,44193,43236,957,151
28-04-2021,Kasaragod,12127,11421,706,21
28-04-2021,total,551133,528407,22726,4436
27-04-2021,Thiruvananthapuram,54569,51824,2745,424
27-04-2021,Kollam,20279,19153,1126,197
27-04-2021,Pathanamthitta,9295,7846,1449,213
27-04-2021,Alappuzha,28077,26403,1674,136
27-04-2021,Kottayam,46894,44744,2150,517
27-04-2021,Idukki,12363,11773,590,68
27-04-2021,Ernakulam,83968,81655,2313,398
27-04-2021,Thrissur,50039,47706,2333,457
27-04-2021,Palakkad,30376,29002,1374,158
27-04-2021,Malappuram,42646,41617,1029,351
27-04-2021,Kozhikode,76276,73794,2482,401
27-04-2021,Wayanad,19675,19090,585,97
27-04-2021,Kannur,41295,40370,925,181
27-04-2021,Kasaragod,11910,11225,685,47
27-04-2021,total,527662,506202,21460,3645
26-04-2021,Thiruvananthapuram,51054,48540,2514,349
26-04-2021,Kollam,20186,19152,1034,192
26-04-2021,Pathanamthitta,9284,7928,1356,162
26-04-2021,Alappuzha,26943,25292,1651,196
26-04-2021,Kottayam,43959,41889,2070,1326
26-04-2021,Idukki,11953,11401,552,34
26-04-2021,Ernakulam,82011,79779,2232,153
26-04-2021,Thrissur,46207,43852,2355,324
26-04-2021,Palakkad,29645,28306,1339,161
26-04-2021,Malappuram,39691,38741,950,298
26-04-2021,Kozhikode,68344,66030,2314,332
26-04-2021,Wayanad,18594,18038,556,63
26-04-2021,Kannur,39004,38158,846,112
26-04-2021,Kasaragod,11321,10672,649,29
26-04-2021,total,498196,477778,20418,3731
23-04-2021,Thiruvananthapuram,41814,39631,2183,353
23-04-2021,Kollam,17746,16864,882,158
23-04-2021,Pathanamthitta,8154,7034,1120,244
23-04-2021,Alappuzha,22137,20877,1260,143
23-04-2021,Kottayam,34059,32392,1667,965
23-04-2021,Idukki,9744,9175,569,60
23-04-2021,Ernakulam,64188,62228,1960,195
23-04-2021,Thrissur,33647,31701,1946,267
23-04-2021,Palakkad,23568,22436,1132,352
23-04-2021,Malappuram,33796,33008,788,266
23-04-2021,Kozhikode,48043,46294,1749,342
23-04-2021,Wayanad,13349,12921,428,106
23-04-2021,Kannur,30782,30052,730,119
23-04-2021,Kasaragod,10436,9851,585,39
23-04-2021,total,391463,374464,16999,3609
22-04-2021,Thiruvananthapuram,38043,35996,2047,361
22-04-2021,Kollam,17164,16342,822,165
22-04-2021,Pathanamthitta,7688,6736,952,145
22-04-2021,Alappuzha,20434,19233,1201,155
22-04-2021,Kottayam,29765,28185,1580,867
22-04-2021,Idukki,8666,8107,559,39
22-04-2021,Ernakulam,57621,55755,1866,288
22-04-2021,Thrissur,29590,27760,1830,286
22-04-2021,Palakkad,21467,20593,874,139
22-04-2021,Malappuram,30484,29673,811,270
22-04-2021,Kozhikode,42953,41334,1619,240
22-04-2021,Wayanad,12435,12068,367,74
22-04-2021,Kannur,28458,27750,708,89
22-04-2021,Kasaragod,10441,9886,555,43
22-04-2021,total,355209,339418,15791,3161
21-04-2021,Thiruvananthapuram,34390,32518,1872,399
21-04-2021,Kollam,16165,15446,719,119
21-04-2021,Pathanamthitta,7058,6276,782,100
21-04-2021,Alappuzha,18390,17229,1161,155
21-04-2021,Kottayam,25859,24368,1491,458
21-04-2021,Idukki,8002,7450,552,53
21-04-2021,Ernakulam,52173,50523,1650,186
21-04-2021,Thrissur,25736,24055,1681,269
21-04-2021,Palakkad,17859,17032,827,111
21-04-2021,Malappuram,28859,28144,715,268
21-04-2021,Kozhikode,37828,36392,1436,256
21-04-2021,Wayanad,11274,10946,328,68
21-04-2021,Kannur,26259,25599,660,90
21-04-2021,Kasaragod,10385,9858,527,48
21-04-2021,total,320237,305836,14401,2580
19-04-2021,Thiruvananthapuram,28880,27344,1536,201
19-04-2021,Kollam,14343,13705,638,111
19-04-2021,Pathanamthitta,6588,5947,641,107
19-04-2021,Alappuzha,14356,13310,1046,207
19-04-2021,Kottayam,19983,18756,1227,718
19-04-2021,Idukki,7471,6992,479,89
19-04-2021,Ernakulam,36157,34631,1526,113
19-04-2021,Thrissur,19664,18334,1330,290
19-04-2021,Palakkad,14124,13367,757,99
19-04-2021,Malappuram,24896,24252,644,224
19-04-2021,Kozhikode,32288,31189,1099,178
19-04-2021,Wayanad,8873,8610,263,58
19-04-2021,Kannur,22077,21482,595,85
19-04-2021,Kasaragod,9739,9239,500,26
19-04-2021,total,259439,247158,12281,2506
17-04-2021,Thiruvananthapuram,24692,23246,1446,194
17-04-2021,Kollam,12566,12031,535,94
17-04-2021,Pathanamthitta,5252,4737,515,78
17-04-2021,Alappuzha,12119,11301,818,119
17-04-2021,Kottayam,16519,15439,1080,215
17-04-2021,Idukki,6439,6042,397,47
17-04-2021,Ernakulam,29641,28227,1414,143
17-04-2021,Thrissur,15574,14631,943,186
17-04-2021,Palakkad,9064,8407,657,102
17-04-2021,Malappuram,22033,21504,529,146
17-04-2021,Kozhikode,27693,26788,905,171
17-04-2021,Wayanad,7107,6891,216,34
17-04-2021,Kannur,19904,19322,582,89
17-04-2021,Kasaragod,9939,9437,502,59
17-04-2021,total,218542,208003,10539,1677
09-04-2021,Thiruvananthapuram,16786,16119,667,119
09-04-2021,Kollam,9696,9429,267,59
09-04-2021,Pathanamthitta,4878,4666,212,43
09-04-2021,Alappuzha,6516,6235,281,68
09-04-2021,Kottayam,12473,11890,583,123
09-04-2021,Idukki,4329,4109,220,29
09-04-2021,Ernakulam,17732,17037,695,70
09-04-2021,Thrissur,11629,11185,444,96
09-04-2021,Palakkad,5059,4734,325,47
09-04-2021,Malappuram,18406,18136,270,86
09-04-2021,Kozhikode,21935,21381,554,92
09-04-2021,Wayanad,4202,4089,113,22
09-04-2021,Kannur,17234,16765,469,45
09-04-2021,Kasaragod,9306,8951,355,34
09-04-2021,total,160181,154726,5455,933
08-04-2021,Thiruvananthapuram,16499,15876,623,90
08-04-2021,Kollam,9771,9520,251,33
08-04-2021,Pathanamthitta,4926,4727,199,28
08-04-2021,Alappuzha,6066,5847,219,33
08-04-2021,Kottayam,11949,11407,542,110
08-04-2021,Idukki,4145,3924,221,29
08-04-2021,Ernakulam,16396,15732,664,72
08-04-2021,Thrissur,11137,10729,408,73
08-04-2021,Palakkad,4938,4656,282,35
08-04-2021,Malappuram,18276,18006,270,89
08-04-2021,Kozhikode,21597,21049,548,86
08-04-2021,Wayanad,3945,3847,98,19
08-04-2021,Kannur,17018,16540,478,46
08-04-2021,Kasaragod,9020,8675,345,16
08-04-2021,total,155683,150535,5148,759
07-04-2021,Thiruvananthapuram,16440,15848,592,80
07-04-2021,Kollam,9693,9440,253,30
07-04-2021,Pathanamthitta,5060,4877,183,20
07-04-2021,Alappuzha,5641,5436,205,48
07-04-2021,Kottayam,10650,10140,510,158
07-04-2021,Idukki,4093,3880,213,35
07-04-2021,Ernakulam,14795,14155,640,80
07-04-2021,Thrissur,10929,10556,373,64
07-04-2021,Palakkad,4736,4454,282,27
07-04-2021,Malappuram,18578,18310,268,88
07-04-2021,Kozhikode,21638,21121,517,74
07-04-2021,Wayanad,3765,3678,87,16
07-04-2021,Kannur,17200,16741,459,52
07-04-2021,Kasaragod,8918,8572,346,24
07-04-2021,total,152136,147208,4928,796
03-04-2021,Thiruvananthapuram,16936,16377,559,55
03-04-2021,Kollam,9888,9639,249,36
03-04-2021,Pathanamthitta,4867,4670,197,15
03-04-2021,Alappuzha,5506,5294,212,28
03-04-2021,Kottayam,9231,8831,400,118
03-04-2021,Idukki,3648,3457,191,23
03-04-2021,Ernakulam,13209,12714,495,66
03-04-2021,Thrissur,10073,9759,314,45
03-04-2021,Palakkad,5015,4771,244,31
03-04-2021,Malappuram,17969,17728,241,63
03-04-2021,Kozhikode,18906,18476,430,54
03-04-2021,Wayanad,3445,3367,78,16
03-04-2021,Kannur,15824,15427,397,58
03-04-2021,Kasaragod,8244,7945,299,26
03-04-2021,total,142761,138455,4306,634
24-03-2021,Thiruvananthapuram,17251,16710,541,57
24-03-2021,Kollam,11134,10883,251,19
24-03-2021,Pathanamthitta,4388,4163,225,19
24-03-2021,Alappuzha,5713,5473,240,19
24-03-2021,Kottayam,7351,6989,362,81
24-03-2021,Idukki,4268,4110,158,20
24-03-2021,Ernakulam,10101,9710,391,36
24-03-2021,Thrissur,8494,8236,258,30
24-03-2021,Palakkad,4747,4541,206,14
24-03-2021,Malappuram,16337,16168,169,38
24-03-2021,Kozhikode,15700,15387,313,45
24-03-2021,Wayanad,2931,2853,78,10
24-03-2021,Kannur,11994,11723,271,32
24-03-2021,Kasaragod,6408,6178,230,17
24-03-2021,total,126817,123124,3693,437
19-03-2021,Thiruvananthapuram,17077,16494,583,67
19-03-2021,Kollam,11558,11271,287,29
19-03-2021,Pathanamthitta,4159,3906,253,34
19-03-2021,Alappuzha,8917,8620,297,27
19-03-2021,Kottayam,8179,7825,354,50
19-03-2021,Idukki,3840,3695,145,20
19-03-2021,Ernakulam,10934,10550,384,26
19-03-2021,Thrissur,9515,9208,307,32
19-03-2021,Palakkad,2917,2710,207,21
19-03-2021,Malappuram,16286,16123,163,31
19-03-2021,Kozhikode,15793,15478,315,35
19-03-2021,Wayanad,2981,2910,71,15
19-03-2021,Kannur,11616,11372,244,29
19-03-2021,Kasaragod,6166,5926,240,22
19-03-2021,total,129938,126088,3850,438
18-03-2021,Thiruvananthapuram,16985,16386,599,78
18-03-2021,Kollam,11705,11411,294,43
18-03-2021,Pathanamthitta,4243,3974,269,15
18-03-2021,Alappuzha,9934,9640,294,30
18-03-2021,Kottayam,8247,7872,375,57
18-03-2021,Idukki,3789,3657,132,18
18-03-2021,Ernakulam,10947,10565,382,35
18-03-2021,Thrissur,9972,9657,315,40
18-03-2021,Palakkad,2914,2719,195,18
18-03-2021,Malappuram,16315,16153,162,30
18-03-2021,Kozhikode,15980,15662,318,36
18-03-2021,Wayanad,3251,3183,68,8
18-03-2021,Kannur,11506,11258,248,25
18-03-2021,Kasaragod,6136,5895,241,26
18-03-2021,total,131924,128032,3892,459
15-03-2021,Thiruvananthapuram,17096,16476,620,52
15-03-2021,Kollam,12310,12021,289,40
15-03-2021,Pathanamthitta,5525,5214,311,15
15-03-2021,Alappuzha,11386,11039,347,25
15-03-2021,Kottayam,8677,8295,382,67
15-03-2021,Idukki,3475,3357,118,13
15-03-2021,Ernakulam,13227,12779,448,75
15-03-2021,Thrissur,11353,10997,356,28
15-03-2021,Palakkad,4925,4732,193,12
15-03-2021,Malappuram,16691,16492,199,36
15-03-2021,Kozhikode,16639,16310,329,43
15-03-2021,Wayanad,3532,3474,58,3
15-03-2021,Kannur,11796,11518,278,29
15-03-2021,Kasaragod,6829,6605,224,11
15-03-2021,total,143461,139309,4152,449
11-03-2021,Thiruvananthapuram,17070,16445,625,77
11-03-2021,Kollam,12523,12177,346,38
11-03-2021,Pathanamthitta,6405,6048,357,40
11-03-2021,Alappuzha,12079,11624,455,68
11-03-2021,Kottayam,10323,9878,445,64
11-03-2021,Idukki,3390,3250,140,12
11-03-2021,Ernakulam,16876,16332,544,50
11-03-2021,Thrissur,16837,16215,622,50
11-03-2021,Palakkad,5340,5113,227,17
11-03-2021,Malappuram,17315,17077,238,74
11-03-2021,Kozhikode,17880,17485,395,42
11-03-2021,Wayanad,4258,4177,81,10
11-03-2021,Kannur,11923,11615,308,29
11-03-2021,Kasaragod,7182,6939,243,23
11-03-2021,total,159401,154375,5026,594
10-03-2021,Thiruvananthapuram,17403,16796,607,64
10-03-2021,Kollam,12641,12292,349,51
10-03-2021,Pathanamthitta,6596,6212,384,23
10-03-2021,Alappuzha,11666,11186,480,36
10-03-2021,Kottayam,10595,10146,449,127
10-03-2021,Idukki,3428,3273,155,11
10-03-2021,Ernakulam,17552,16994,558,78
10-03-2021,Thrissur,18798,18171,627,51
10-03-2021,Palakkad,5454,5223,231,27
10-03-2021,Malappuram,16974,16745,229,65
10-03-2021,Kozhikode,17960,17552,408,28
10-03-2021,Wayanad,4262,4182,80,4
10-03-2021,Kannur,11924,11598,326,34
10-03-2021,Kasaragod,7513,7278,235,17
10-03-2021,total,162766,157648,5118,616
04-03-2021,Thiruvananthapuram,19991,19230,761,63
04-03-2021,Kollam,13211,12748,463,45
04-03-2021,Pathanamthitta,14430,13912,518,43
04-03-2021,Alappuzha,14314,13720,594,57
04-03-2021,Kottayam,13537,12934,603,89
04-03-2021,Idukki,2786,2571,215,25
04-03-2021,Ernakulam,23375,22654,721,63
04-03-2021,Thrissur,20857,19898,959,63
04-03-2021,Palakkad,6847,6561,286,28
04-03-2021,Malappuram,18620,18344,276,76
04-03-2021,Kozhikode,19998,19474,524,59
04-03-2021,Wayanad,4564,4441,123,11
04-03-2021,Kannur,9742,9390,352,44
04-03-2021,Kasaragod,6840,6592,248,14
04-03-2021,total,189112,182469,6643,680
23-02-2021,Thiruvananthapuram,25793,24800,993,105
23-02-2021,Kollam,16685,16144,541,70
23-02-2021,Pathanamthitta,22410,21638,772,67
23-02-2021,Alappuzha,16230,15457,773,41
23-02-2021,Kottayam,17639,16726,913,65
23-02-2021,Idukki,4785,4543,242,11
23-02-2021,Ernakulam,27153,26217,936,62
23-02-2021,Thrissur,23522,22775,747,56
23-02-2021,Palakkad,9632,9285,347,43
23-02-2021,Malappuram,23627,23261,366,84
23-02-2021,Kozhikode,24399,23786,613,71
23-02-2021,Wayanad,5842,5650,192,21
23-02-2021,Kannur,10959,10641,318,27
23-02-2021,Kasaragod,6549,6219,330,61
23-02-2021,total,235225,227142,8083,784
03-02-2021,Thiruvananthapuram,24280,22996,1284,161
03-02-2021,Kollam,11369,10598,771,97
03-02-2021,Pathanamthitta,14247,13440,807,73
03-02-2021,Alappuzha,12232,11095,1137,94
03-02-2021,Kottayam,17482,16265,1217,352
03-02-2021,Idukki,10143,9639,504,28
03-02-2021,Ernakulam,27482,26069,1413,176
03-02-2021,Thrissur,21673,20741,932,114
03-02-2021,Palakkad,9795,9269,526,53
03-02-2021,Malappuram,21037,20573,464,98
03-02-2021,Kozhikode,22185,21299,886,125
03-02-2021,Wayanad,7277,6961,316,28
03-02-2021,Kannur,13133,12603,530,62
03-02-2021,Kasaragod,5983,5767,216,11
03-02-2021,total,218318,207315,11003,1472
30-01-2021,Thiruvananthapuram,23733,22371,1362,184
30-01-2021,Kollam,11979,11163,816,111
30-01-2021,Pathanamthitta,14259,13331,928,84
30-01-2021,Alappuzha,12579,11405,1174,119
30-01-2021,Kottayam,16874,15691,1183,439
30-01-2021,Idukki,9827,9318,509,50
30-01-2021,Ernakulam,27320,25881,1439,134
30-01-2021,Thrissur,22394,21443,951,116
30-01-2021,Palakkad,9555,9013,542,42
30-01-2021,Malappuram,20623,20164,459,61
30-01-2021,Kozhikode,21967,21036,931,114
30-01-2021,Wayanad,7387,6999,388,38
30-01-2021,Kannur,12805,12252,553,79
30-01-2021,Kasaragod,6132,5859,273,30
30-01-2021,total,217434,205926,11508,1601
27-01-2021,Thiruvananthapuram,23509,22168,1341,121
27-01-2021,Kollam,11968,11071,897,105
27-01-2021,Pathanamthitta,14318,13222,1096,59
27-01-2021,Alappuzha,12181,11046,1135,133
27-01-2021,Kottayam,16356,14934,1422,224
27-01-2021,Idukki,9200,8670,530,28
27-01-2021,Ernakulam,27207,25659,1548,103
27-01-2021,Thrissur,21559,20652,907,127
27-01-2021,Palakkad,9287,8771,516,68
27-01-2021,Malappuram,20703,20145,558,100
27-01-2021,Kozhikode,21828,20846,982,82
27-01-2021,Wayanad,7051,6620,431,37
27-01-2021,Kannur,13131,12614,517,65
27-01-2021,Kasaragod,6017,5778,239,17
27-01-2021,total,214315,202196,12119,1269
19-01-2021,Thiruvananthapuram,21973,20769,1204,148
19-01-2021,Kollam,11647,10924,723,117
19-01-2021,Pathanamthitta,13789,12799,990,66
19-01-2021,Alappuzha,9706,8724,982,61
19-01-2021,Kottayam,13868,12564,1304,113
19-01-2021,Idukki,7862,7346,516,38
19-01-2021,Ernakulam,25158,23748,1410,101
19-01-2021,Thrissur,23259,22392,867,71
19-01-2021,Palakkad,9458,9018,440,45
19-01-2021,Malappuram,20917,20319,598,95
19-01-2021,Kozhikode,22048,21095,953,102
19-01-2021,Wayanad,8895,8559,336,42
19-01-2021,Kannur,13896,13465,431,55
19-01-2021,Kasaragod,6699,6448,251,6
19-01-2021,total,209175,198170,11005,1060
11-01-2021,Thiruvananthapuram,21086,19939,1147,109
11-01-2021,Kollam,11126,10518,608,48
11-01-2021,Pathanamthitta,10761,9686,1075,109
11-01-2021,Alappuzha,8072,7035,1037,91
11-01-2021,Kottayam,13265,12081,1184,113
11-01-2021,Idukki,7248,6784,464,51
11-01-2021,Ernakulam,22060,20714,1346,51
11-01-2021,Thrissur,25297,24298,999,78
11-01-2021,Palakkad,9676,9208,468,51
11-01-2021,Malappuram,21839,21194,645,90
11-01-2021,Kozhikode,20962,20087,875,68
11-01-2021,Wayanad,8992,8650,342,22
11-01-2021,Kannur,13911,13538,373,51
11-01-2021,Kasaragod,5103,4884,219,16
11-01-2021,total,199398,188616,10782,948
09-01-2021,Thiruvananthapuram,20853,19695,1158,113
09-01-2021,Kollam,10320,9671,649,91
09-01-2021,Pathanamthitta,10711,9577,1134,118
09-01-2021,Alappuzha,7724,6579,1145,159
09-01-2021,Kottayam,12857,11681,1176,157
09-01-2021,Idukki,6811,6354,457,58
09-01-2021,Ernakulam,27708,26344,1364,145
09-01-2021,Thrissur,25474,24418,1056,145
09-01-2021,Palakkad,9573,9120,453,41
09-01-2021,Malappuram,22075,21444,631,70
09-01-2021,Kozhikode,20906,20019,887,75
09-01-2021,Wayanad,8823,8473,350,36
09-01-2021,Kannur,13861,13476,385,40
09-01-2021,Kasaragod,4475,4265,210,20
09-01-2021,total,202171,191116,11055,1268
04-01-2021,Thiruvananthapuram,20050,18908,1142,129
04-01-2021,Kollam,9971,9229,742,65
04-01-2021,Pathanamthitta,10634,9444,1190,140
04-01-2021,Alappuzha,6848,5818,1030,130
04-01-2021,Kottayam,11989,10700,1289,187
04-01-2021,Idukki,6998,6601,397,42
04-01-2021,Ernakulam,26267,24962,1305,245
04-01-2021,Thrissur,23348,22218,1130,102
04-01-2021,Palakkad,9372,8867,505,36
04-01-2021,Malappuram,61339,60509,830,98
04-01-2021,Kozhikode,20614,19714,900,39
04-01-2021,Wayanad,8533,8177,356,22
04-01-2021,Kannur,12263,11828,435,34
04-01-2021,Kasaragod,3909,3724,185,8
04-01-2021,total,232135,220699,11436,1277
03-01-2021,Thiruvananthapuram,20183,19065,1118,109
03-01-2021,Kollam,9630,8919,711,51
03-01-2021,Pathanamthitta,10637,9407,1230,153
03-01-2021,Alappuzha,6930,5909,1021,134
03-01-2021,Kottayam,13117,11840,1277,144
03-01-2021,Idukki,6908,6538,370,99
03-01-2021,Ernakulam,25898,24678,1220,116
03-01-2021,Thrissur,23044,21910,1134,120
03-01-2021,Palakkad,9556,9038,518,40
03-01-2021,Malappuram,65387,64548,839,90
03-01-2021,Kozhikode,20710,19830,880,93
03-01-2021,Wayanad,8413,8038,375,37
03-01-2021,Kannur,12279,11813,466,47
03-01-2021,Kasaragod,3972,3762,210,8
03-01-2021,total,236664,225295,11369,1241
30-12-2020,Thiruvananthapuram,21811,20615,1196,170
30-12-2020,Kollam,11854,10920,934,118
30-12-2020,Pathanamthitta,10604,9483,1121,91
30-12-2020,Alappuzha,7029,6079,950,80
30-12-2020,Kottayam,12361,10914,1447,290
30-12-2020,Idukki,7782,7474,308,29
30-12-2020,Ernakulam,30429,29206,1223,150
30-12-2020,Thrissur,21586,20377,1209,183
30-12-2020,Palakkad,10046,9446,600,62
30-12-2020,Malappuram,67783,66905,878,62
30-12-2020,Kozhikode,21021,19982,1039,88
30-12-2020,Wayanad,9069,8518,551,50
30-12-2020,Kannur,12040,11589,451,42
30-12-2020,Kasaragod,4310,4101,209,11
30-12-2020,total,247725,235609,12116,1426
28-12-2020,Thiruvananthapuram,22972,21759,1213,82
28-12-2020,Kollam,11607,10674,933,79
28-12-2020,Pathanamthitta,9864,8733,1131,127
28-12-2020,Alappuzha,6963,5970,993,79
28-12-2020,Kottayam,13443,11762,1681,197
28-12-2020,Idukki,7887,7519,368,12
28-12-2020,Ernakulam,29341,28094,1247,135
28-12-2020,Thrissur,21818,20565,1253,122
28-12-2020,Palakkad,10542,9877,665,41
28-12-2020,Malappuram,68676,67746,930,48
28-12-2020,Kozhikode,21845,20807,1038,98
28-12-2020,Wayanad,9641,9079,562,29
28-12-2020,Kannur,11022,10563,459,59
28-12-2020,Kasaragod,4553,4312,241,8
28-12-2020,total,250174,237460,12714,1116
16-12-2020,Thiruvananthapuram,25585,24434,1151,132
16-12-2020,Kollam,14414,13751,663,86
16-12-2020,Pathanamthitta,9561,8542,1019,104
16-12-2020,Alappuzha,7536,6540,996,95
16-12-2020,Kottayam,12360,10707,1653,325
16-12-2020,Idukki,8054,7686,368,42
16-12-2020,Ernakulam,30796,29495,1301,199
16-12-2020,Thrissur,23878,22546,1332,189
16-12-2020,Palakkad,12674,11790,884,56
16-12-2020,Malappuram,81611,80544,1067,158
16-12-2020,Kozhikode,33618,32392,1226,117
16-12-2020,Wayanad,11110,10420,690,103
16-12-2020,Kannur,20940,20399,541,69
16-12-2020,Kasaragod,6920,6673,247,3
16-12-2020,total,299057,285919,13138,1678
11-12-2020,Thiruvananthapuram,30350,29262,1088,122
11-12-2020,Kollam,14905,14232,673,101
11-12-2020,Pathanamthitta,10010,9074,936,139
11-12-2020,Alappuzha,8397,7262,1135,106
11-12-2020,Kottayam,13058,11429,1629,146
11-12-2020,Idukki,9673,9313,360,54
11-12-2020,Ernakulam,28471,27155,1316,108
11-12-2020,Thrissur,24247,22733,1514,126
11-12-2020,Palakkad,14148,13209,939,59
11-12-2020,Malappuram,86079,85015,1064,142
11-12-2020,Kozhikode,33421,32014,1407,136
11-12-2020,Wayanad,12009,11343,666,27
11-12-2020,Kannur,23454,22916,538,77
11-12-2020,Kasaragod,7422,7145,277,36
11-12-2020,total,315644,302102,13542,1379
10-12-2020,Thiruvananthapuram,31208,30056,1152,138
10-12-2020,Kollam,14993,14299,694,90
10-12-2020,Pathanamthitta,10135,9257,878,62
10-12-2020,Alappuzha,8530,7420,1110,84
10-12-2020,Kottayam,13593,11958,1635,202
10-12-2020,Idukki,9542,9201,341,16
10-12-2020,Ernakulam,28386,27038,1348,107
10-12-2020,Thrissur,24498,22904,1594,102
10-12-2020,Palakkad,14615,13611,1004,79
10-12-2020,Malappuram,85445,84301,1144,107
10-12-2020,Kozhikode,32384,30912,1472,154
10-12-2020,Wayanad,12216,11428,788,62
10-12-2020,Kannur,23747,23243,504,60
10-12-2020,Kasaragod,7199,6939,260,15
10-12-2020,total,316491,302567,13924,1278
05-12-2020,Thiruvananthapuram,32927,31595,1332,127
05-12-2020,Kollam,14617,13839,778,90
05-12-2020,Pathanamthitta,10388,9485,903,111
05-12-2020,Alappuzha,9185,7930,1255,144
05-12-2020,Kottayam,11412,9626,1786,215
05-12-2020,Idukki,11615,11200,415,35
05-12-2020,Ernakulam,29630,28292,1338,113
05-12-2020,Thrissur,25841,24077,1764,229
05-12-2020,Palakkad,15195,14159,1036,121
05-12-2020,Malappuram,87633,86389,1244,158
05-12-2020,Kozhikode,27200,25665,1535,167
05-12-2020,Wayanad,9915,9082,833,91
05-12-2020,Kannur,21364,20857,507,59
05-12-2020,Kasaragod,8102,7766,336,61
05-12-2020,total,315024,299962,15062,1721
03-12-2020,Thiruvananthapuram,33158,31778,1380,156
03-12-2020,Kollam,15033,14167,866,97
03-12-2020,Pathanamthitta,10359,9501,858,119
03-12-2020,Alappuzha,9524,8275,1249,172
03-12-2020,Kottayam,10903,9036,1867,228
03-12-2020,Idukki,11820,11404,416,56
03-12-2020,Ernakulam,28582,27251,1331,91
03-12-2020,Thrissur,26950,25265,1685,212
03-12-2020,Palakkad,15988,14893,1095,109
03-12-2020,Malappuram,84568,83312,1256,118
03-12-2020,Kozhikode,25655,24064,1591,196
03-12-2020,Wayanad,9145,8311,834,100
03-12-2020,Kannur,21426,20919,507,42
03-12-2020,Kasaragod,8126,7805,321,20
03-12-2020,total,311237,295981,15256,1716
22-11-2020,Thiruvananthapuram,28241,26644,1597,126
22-11-2020,Kollam,20312,18939,1373,132
22-11-2020,Pathanamthitta,10208,9465,743,107
22-11-2020,Alappuzha,12645,11158,1487,135
22-11-2020,Kottayam,20474,18855,1619,228
22-11-2020,Idukki,14681,14235,446,40
22-11-2020,Ernakulam,28436,26859,1577,199
22-11-2020,Thrissur,28511,26711,1800,195
22-11-2020,Palakkad,16162,14994,1168,138
22-11-2020,Malappuram,82874,81575,1299,128
22-11-2020,Kozhikode,24688,23009,1679,236
22-11-2020,Wayanad,10461,9848,613,78
22-11-2020,Kannur,16730,16082,648,63
22-11-2020,Kasaragod,6874,6517,357,24
22-11-2020,total,321297,304891,16406,1829
20-11-2020,Thiruvananthapuram,27480,25796,1684,170
20-11-2020,Kollam,19240,17858,1382,175
20-11-2020,Pathanamthitta,10227,9491,736,121
20-11-2020,Alappuzha,12930,11349,1581,224
20-11-2020,Kottayam,19835,18298,1537,182
20-11-2020,Idukki,14762,14330,432,78
20-11-2020,Ernakulam,28390,26793,1597,124
20-11-2020,Thrissur,28379,26553,1826,264
20-11-2020,Palakkad,16419,15293,1126,136
20-11-2020,Malappuram,78862,77618,1244,152
20-11-2020,Kozhikode,24824,23152,1672,223
20-11-2020,Wayanad,11265,10707,558,88
20-11-2020,Kannur,16489,15833,656,54
20-11-2020,Kasaragod,6416,6018,398,41
20-11-2020,total,315518,299089,16429,2032
16-11-2020,Thiruvananthapuram,27233,25261,1972,126
16-11-2020,Kollam,18462,17302,1160,116
16-11-2020,Pathanamthitta,10237,9505,732,72
16-11-2020,Alappuzha,14940,13201,1739,369
16-11-2020,Kottayam,20796,19109,1687,159
16-11-2020,Idukki,13707,13251,456,40
16-11-2020,Ernakulam,31785,29905,1880,98
16-11-2020,Thrissur,28343,26266,2077,236
16-11-2020,Palakkad,16553,15450,1103,129
16-11-2020,Malappuram,75057,73912,1145,232
16-11-2020,Kozhikode,26352,24464,1888,149
16-11-2020,Wayanad,12274,11768,506,25
16-11-2020,Kannur,17390,16676,714,52
16-11-2020,Kasaragod,6133,5669,464,12
16-11-2020,total,319262,301739,17523,1815
03-11-2020,Thiruvananthapuram,27882,25250,2632,262
03-11-2020,Kollam,17318,16008,1310,154
03-11-2020,Pathanamthitta,10238,9322,916,61
03-11-2020,Alappuzha,13163,11849,1314,474
03-11-2020,Kottayam,18894,16776,2118,169
03-11-2020,Idukki,11997,11640,357,34
03-11-2020,Ernakulam,31649,29377,2272,75
03-11-2020,Thrissur,27217,24674,2543,282
03-11-2020,Palakkad,15322,14121,1201,127
03-11-2020,Malappuram,62477,60910,1567,158
03-11-2020,Kozhikode,27030,24516,2514,290
03-11-2020,Wayanad,8711,8159,552,65
03-11-2020,Kannur,20248,19329,919,100
03-11-2020,Kasaragod,4468,3913,555,38
03-11-2020,total,296614,275844,20770,2289
28-10-2020,Thiruvananthapuram,28539,25670,2869,359
28-10-2020,Kollam,17946,16481,1465,207
28-10-2020,Pathanamthitta,10246,9202,1044,47
28-10-2020,Alappuzha,12566,10849,1717,531
28-10-2020,Kottayam,20453,18552,1901,249
28-10-2020,Idukki,11055,10644,411,24
28-10-2020,Ernakulam,32403,30209,2194,166
28-10-2020,Thrissur,21503,19117,2386,222
28-10-2020,Palakkad,17656,16478,1178,148
28-10-2020,Malappuram,59378,57587,1791,206
28-10-2020,Kozhikode,27559,24760,2799,309
28-10-2020,Wayanad,7050,6440,610,107
28-10-2020,Kannur,19425,18408,1017,26
28-10-2020,Kasaragod,4725,4109,616,15
28-10-2020,total,290504,268506,21998,2616
27-10-2020,Thiruvananthapuram,28082,25158,2924,245
27-10-2020,Kollam,15844,14482,1362,90
27-10-2020,Pathanamthitta,10231,9114,1117,200
27-10-2020,Alappuzha,12568,11016,1552,457
27-10-2020,Kottayam,19454,17633,1821,121
27-10-2020,Idukki,10752,10350,402,24
27-10-2020,Ernakulam,32096,29905,2191,106
27-10-2020,Thrissur,20567,18173,2394,360
27-10-2020,Palakkad,17158,15967,1191,100
27-10-2020,Malappuram,57726,56027,1699,204
27-10-2020,Kozhikode,28124,25381,2743,247
27-10-2020,Wayanad,6623,6063,560,62
27-10-2020,Kannur,19172,18147,1025,108
27-10-2020,Kasaragod,4753,4147,606,15
27-10-2020,total,283150,261563,21587,2339
23-10-2020,Thiruvananthapuram,28445,25224,3221,425
23-10-2020,Kollam,18556,17189,1367,152
23-10-2020,Pathanamthitta,9858,8896,962,121
23-10-2020,Alappuzha,13812,12345,1467,402
23-10-2020,Kottayam,17196,14905,2291,188
23-10-2020,Idukki,10585,10166,419,32
23-10-2020,Ernakulam,31859,29554,2305,224
23-10-2020,Thrissur,18492,16288,2204,321
23-10-2020,Palakkad,17767,16495,1272,143
23-10-2020,Malappuram,55329,53632,1697,211
23-10-2020,Kozhikode,29678,26636,3042,303
23-10-2020,Wayanad,5966,5268,698,79
23-10-2020,Kannur,17785,16769,1016,121
23-10-2020,Kasaragod,4856,4037,819,48
23-10-2020,total,280184,257404,22780,2770
12-10-2020,Thiruvananthapuram,31842,27541,4301,415
12-10-2020,Kollam,18652,17103,1549,138
12-10-2020,Pathanamthitta,8856,7755,1101,167
12-10-2020,Alappuzha,14662,11503,3159,585
12-10-2020,Kottayam,18755,16662,2093,211
12-10-2020,Idukki,13550,13078,472,49
12-10-2020,Ernakulam,33432,30953,2479,143
12-10-2020,Thrissur,14996,12509,2487,309
12-10-2020,Palakkad,17330,15614,1716,200
12-10-2020,Malappuram,51380,49334,2046,193
12-10-2020,Kozhikode,32110,28335,3775,414
12-10-2020,Wayanad,4522,3671,851,34
12-10-2020,Kannur,16309,15212,1097,155
12-10-2020,Kasaragod,5017,3834,1183,62
12-10-2020,total,281413,253104,28309,3075
10-10-2020,Thiruvananthapuram,31510,27068,4442,716
10-10-2020,Kollam,19245,17628,1617,246
10-10-2020,Pathanamthitta,8807,7700,1107,140
10-10-2020,Alappuzha,14320,11102,3218,784
10-10-2020,Kottayam,18353,16390,1963,114
10-10-2020,Idukki,12743,12296,447,46
10-10-2020,Ernakulam,33106,30539,2567,232
10-10-2020,Thrissur,14586,12079,2507,320
10-10-2020,Palakkad,18634,16845,1789,187
10-10-2020,Malappuram,50848,48884,1964,206
10-10-2020,Kozhikode,32081,28363,3718,502
10-10-2020,Wayanad,4318,3470,848,137
10-10-2020,Kannur,16464,15284,1180,161
10-10-2020,Kasaragod,5372,4066,1306,97
10-10-2020,total,280387,251714,28673,3888
09-10-2020,Thiruvananthapuram,30946,26558,4388,344
09-10-2020,Kollam,19123,17543,1580,140
09-10-2020,Pathanamthitta,8737,7646,1091,220
09-10-2020,Alappuzha,13741,10959,2782,58
09-10-2020,Kottayam,17616,15686,1930,118
09-10-2020,Idukki,12576,12135,441,58
09-10-2020,Ernakulam,32594,29777,2817,275
09-10-2020,Thrissur,14506,11976,2530,306
09-10-2020,Palakkad,18527,16719,1808,285
09-10-2020,Malappuram,48488,46478,2010,251
09-10-2020,Kozhikode,31817,28196,3621,516
09-10-2020,Wayanad,4129,3325,804,128
09-10-2020,Kannur,15592,14347,1245,124
09-10-2020,Kasaragod,5294,3916,1378,69
09-10-2020,total,273686,245261,28425,2892
08-10-2020,Thiruvananthapuram,31100,26707,4393,473
08-10-2020,Kollam,18998,17307,1691,187
08-10-2020,Pathanamthitta,8698,7664,1034,213
08-10-2020,Alappuzha,13680,10420,3260,672
08-10-2020,Kottayam,18343,16392,1951,240
08-10-2020,Idukki,12672,12207,465,72
08-10-2020,Ernakulam,32036,29057,2979,526
08-10-2020,Thrissur,14279,11630,2649,296
08-10-2020,Palakkad,18242,16429,1813,215
08-10-2020,Malappuram,47204,45126,2078,243
08-10-2020,Kozhikode,31381,27817,3564,561
08-10-2020,Wayanad,4044,3258,786,109
08-10-2020,Kannur,15404,14028,1376,125
08-10-2020,Kasaragod,5358,4014,1344,134
08-10-2020,total,271439,242056,29383,4066
07-10-2020,Thiruvananthapuram,30920,26591,4329,373
07-10-2020,Kollam,18941,17196,1745,250
07-10-2020,Pathanamthitta,8636,7698,938,8
07-10-2020,Alappuzha,13392,10411,2981,186
07-10-2020,Kottayam,19216,16818,2398,252
07-10-2020,Idukki,12199,11762,437,38
07-10-2020,Ernakulam,31319,28404,2915,310
07-10-2020,Thrissur,13756,10909,2847,307
07-10-2020,Palakkad,17342,15744,1598,173
07-10-2020,Malappuram,47015,44870,2145,229
07-10-2020,Kozhikode,30855,27093,3762,448
07-10-2020,Wayanad,4058,3276,782,79
07-10-2020,Kannur,15453,14064,1389,144
07-10-2020,Kasaragod,4732,3495,1237,125
07-10-2020,total,267834,238331,29503,2922
29-09-2020,Thiruvananthapuram,29100,25000,4100,436
29-09-2020,Kollam,19651,17684,1967,171
29-09-2020,Pathanamthitta,8099,6994,1105,159
29-09-2020,Alappuzha,13866,10633,3233,244
29-09-2020,Kottayam,21284,18709,2575,186
29-09-2020,Idukki,10132,9478,654,89
29-09-2020,Ernakulam,26055,23363,2692,250
29-09-2020,Thrissur,11913,9514,2399,321
29-09-2020,Palakkad,10363,8658,1705,164
29-09-2020,Malappuram,38537,36090,2447,231
29-09-2020,Kozhikode,24804,21737,3067,378
29-09-2020,Wayanad,3794,3125,669,106
29-09-2020,Kannur,15029,13864,1165,138
29-09-2020,Kasaragod,4333,3409,924,33
29-09-2020,total,236960,208258,28702,2906
22-09-2020,Thiruvananthapuram,26245,22234,4011,374
22-09-2020,Kollam,22106,20545,1561,171
22-09-2020,Pathanamthitta,7661,6638,1023,18
22-09-2020,Alappuzha,12339,10034,2305,108
22-09-2020,Kottayam,20051,17787,2264,127
22-09-2020,Idukki,8438,7878,560,74
22-09-2020,Ernakulam,22807,20708,2099,251
22-09-2020,Thrissur,11592,9884,1708,185
22-09-2020,Palakkad,8506,6770,1736,225
22-09-2020,Malappuram,35713,33273,2440,295
22-09-2020,Kozhikode,21614,18222,3392,382
22-09-2020,Wayanad,3458,2801,657,71
22-09-2020,Kannur,15010,14018,992,115
22-09-2020,Kasaragod,4730,3696,1034,34
22-09-2020,total,220270,194488,25782,2430
18-09-2020,Thiruvananthapuram,25538,21524,4014,441
18-09-2020,Kollam,23528,21875,1653,219
18-09-2020,Pathanamthitta,7313,6271,1042,122
18-09-2020,Alappuzha,11451,9109,2342,366
18-09-2020,Kottayam,19970,18022,1948,157
18-09-2020,Idukki,7545,7037,508,93
18-09-2020,Ernakulam,23731,21808,1923,253
18-09-2020,Thrissur,11581,10029,1552,232
18-09-2020,Palakkad,8661,7138,1523,224
18-09-2020,Malappuram,32954,30480,2474,345
18-09-2020,Kozhikode,20820,17810,3010,484
18-09-2020,Wayanad,3082,2509,573,94
18-09-2020,Kannur,15239,14251,988,125
18-09-2020,Kasaragod,4849,3765,1084,127
18-09-2020,total,216262,191628,24634,3282
14-09-2020,Thiruvananthapuram,24651,20849,3802,320
14-09-2020,Kollam,20120,18326,1794,106
14-09-2020,Pathanamthitta,6668,5651,1017,81
14-09-2020,Alappuzha,9576,7582,1994,244
14-09-2020,Kottayam,20415,18568,1847,164
14-09-2020,Idukki,7027,6589,438,50
14-09-2020,Ernakulam,23096,21245,1851,147
14-09-2020,Thrissur,10848,9465,1383,138
14-09-2020,Palakkad,9664,8442,1222,99
14-09-2020,Malappuram,31936,29798,2138,307
14-09-2020,Kozhikode,18819,16271,2548,367
14-09-2020,Wayanad,2959,2473,486,50
14-09-2020,Kannur,14091,12742,1349,106
14-09-2020,Kasaragod,5288,4240,1048,34
14-09-2020,total,205158,182241,22917,2213
11-09-2020,Thiruvananthapuram,23516,19867,3649,425
11-09-2020,Kollam,17405,15686,1719,206
11-09-2020,Pathanamthitta,6275,5146,1129,141
11-09-2020,Alappuzha,9168,7468,1700,267
11-09-2020,Kottayam,19340,17680,1660,219
11-09-2020,Idukki,6243,5885,358,60
11-09-2020,Ernakulam,23042,21212,1830,178
11-09-2020,Thrissur,11248,9973,1275,195
11-09-2020,Palakkad,8451,7447,1004,198
11-09-2020,Malappuram,39110,37244,1866,249
11-09-2020,Kozhikode,16924,14860,2064,273
11-09-2020,Wayanad,2768,2304,464,96
11-09-2020,Kannur,13827,12263,1564,122
11-09-2020,Kasaragod,5939,4729,1210,60
11-09-2020,total,203256,181764,21492,2689
02-09-2020,Thiruvananthapuram,21726,18039,3687,288
02-09-2020,Kollam,14862,13443,1419,148
02-09-2020,Pathanamthitta,6080,5249,831,23
02-09-2020,Alappuzha,9678,7914,1764,32
02-09-2020,Kottayam,15083,13814,1269,66
02-09-2020,Idukki,4359,4112,247,13
02-09-2020,Ernakulam,17944,16362,1582,121
02-09-2020,Thrissur,10119,8799,1320,169
02-09-2020,Palakkad,10860,10225,635,24
02-09-2020,Malappuram,47156,45436,1720,185
02-09-2020,Kozhikode,14838,13018,1820,212
02-09-2020,Wayanad,3031,2792,239,31
02-09-2020,Kannur,11612,10582,1030,118
02-09-2020,Kasaragod,6388,5597,791,9
02-09-2020,total,193736,175382,18354,1439
29-08-2020,Thiruvananthapuram,24148,20213,3935,423
29-08-2020,Kollam,15223,14046,1177,123
29-08-2020,Pathanamthitta,5825,4919,906,113
29-08-2020,Alappuzha,9780,7537,2243,185
29-08-2020,Kottayam,13725,12589,1136,124
29-08-2020,Idukki,4460,4163,297,45
29-08-2020,Ernakulam,17972,16469,1503,187
29-08-2020,Thrissur,10127,8891,1236,222
29-08-2020,Palakkad,12414,11686,728,146
29-08-2020,Malappuram,46195,44174,2021,249
29-08-2020,Kozhikode,15151,13323,1828,277
29-08-2020,Wayanad,3782,3489,293,20
29-08-2020,Kannur,11527,10467,1060,165
29-08-2020,Kasaragod,5598,4856,742,84
29-08-2020,total,195927,176822,19105,2363
24-08-2020,Thiruvananthapuram,24050,20187,3863,287
24-08-2020,Kollam,9195,8314,881,31
24-08-2020,Pathanamthitta,5724,5058,666,131
24-08-2020,Alappuzha,9444,7573,1871,224
24-08-2020,Kottayam,13133,12205,928,106
24-08-2020,Idukki,4302,4017,285,28
24-08-2020,Ernakulam,17318,15954,1364,257
24-08-2020,Thrissur,9802,8783,1019,78
24-08-2020,Palakkad,13515,12949,566,76
24-08-2020,Malappuram,43035,40773,2262,255
24-08-2020,Kozhikode,14812,13321,1491,232
24-08-2020,Wayanad,3771,3477,294,12
24-08-2020,Kannur,10059,9232,827,113
24-08-2020,Kasaragod,5288,4568,720,47
24-08-2020,total,183448,166411,17037,1877
10-12-2021,Thiruvananthapuram,29132,27863,1269,30
10-12-2021,Kollam,8914,8608,306,33
10-12-2021,Pathanamthitta,3306,2895,411,6
10-12-2021,Alappuzha,3312,3257,55,7
10-12-2021,Kottayam,20074,19711,363,13
10-12-2021,Idukki,2810,2716,94,5
10-12-2021,Ernakulam,24211,23611,600,31
10-12-2021,Thrissur,5060,4866,194,26
10-12-2021,Palakkad,13340,13196,144,20
10-12-2021,Malappuram,10976,10772,204,14
10-12-2021,Kozhikode,16915,16630,285,21
10-12-2021,Wayanad,11867,11751,116,16
10-12-2021,Kannur,7854,7558,296,27
10-12-2021,Kasaragod,4122,3866,256,9
10-12-2021,total,161893,157300,4593,258
13-12-2021,Thiruvananthapuram,29961,28692,1269,30
13-12-2021,Kollam,8435,8159,276,34
13-12-2021,Pathanamthitta,3058,2638,420,
13-12-2021,Alappuzha,3183,3136,47,5
13-12-2021,Kottayam,19205,18877,328,3
13-12-2021,Idukki,5934,5831,103,3
13-12-2021,Ernakulam,22511,21963,548,14
13-12-2021,Thrissur,4675,4493,182,35
13-12-2021,Palakkad,11514,11377,137,14
13-12-2021,Malappuram,10627,10437,190,18
13-12-2021,Kozhikode,17257,16983,274,9
13-12-2021,Wayanad,11359,11279,80,3
13-12-2021,Kannur,7963,7779,184,31
13-12-2021,Kasaragod,4351,4076,275,8
13-12-2021,total,160033,155720,4313,207
14-12-2021,Thiruvananthapuram,29002,27733,1269,30
14-12-2021,Kollam,8276,8002,274,20
14-12-2021,Pathanamthitta,3450,3041,409,3
14-12-2021,Alappuzha,3119,3071,48,11
14-12-2021,Kottayam,18636,18298,338,0
14-12-2021,Idukki,3347,3256,91,2
14-12-2021,Ernakulam,22074,21510,564,26
14-12-2021,Thrissur,4448,4267,181,34
14-12-2021,Palakkad,10072,9941,131,14
14-12-2021,Malappuram,10446,10262,184,10
14-12-2021,Kozhikode,16683,16435,248,13
14-12-2021,Wayanad,11226,11158,68,11
14-12-2021,Kannur,8013,7833,180,30
14-12-2021,Kasaragod,4682,4438,244,9
14-12-2021,total,153474,149245,4229,213
20-12-2021,Thiruvananthapuram,26883,25614,1269,30
20-12-2021,Kollam,7132,6886,246,33
20-12-2021,Pathanamthitta,5447,5187,260,3
20-12-2021,Alappuzha,4034,3991,43,11
20-12-2021,Kottayam,13568,13235,333,0
20-12-2021,Idukki,2677,2589,88,3
20-12-2021,Ernakulam,18010,17480,530,14
20-12-2021,Thrissur,4350,3843,507,14
20-12-2021,Palakkad,8766,8690,76,7
20-12-2021,Malappuram,9559,9381,178,18
20-12-2021,Kozhikode,15533,15292,241,28
20-12-2021,Wayanad,10517,10448,69,9
20-12-2021,Kannur,7872,7723,149,17
20-12-2021,Kasaragod,5090,4841,249,6
20-12-2021,total,139438,135200,4238,193
19-12-2021,Thiruvananthapuram,26117,24848,1269,30
19-12-2021,Kollam,7651,7415,236,21
19-12-2021,Pathanamthitta,5104,4842,262,12
19-12-2021,Alappuzha,4067,4024,43,2
19-12-2021,Kottayam,12946,12612,334,5
19-12-2021,Idukki,2680,2597,83,2
19-12-2021,Ernakulam,18645,18120,525,32
19-12-2021,Thrissur,4481,3966,515,15
19-12-2021,Palakkad,9274,9198,76,11
19-12-2021,Malappuram,9917,9768,149,12
19-12-2021,Kozhikode,16051,15817,234,18
19-12-2021,Wayanad,10318,10256,62,12
19-12-2021,Kannur,8026,7872,154,27
19-12-2021,Kasaragod,5056,4792,264,7
19-12-2021,total,140333,136127,4206,206
18-12-2021,Thiruvananthapuram,26569,25300,1269,30
18-12-2021,Kollam,8253,8021,232,36
18-12-2021,Pathanamthitta,4830,4580,250,4
18-12-2021,Alappuzha,4149,4104,45,2
18-12-2021,Kottayam,12842,12506,336,12
18-12-2021,Idukki,2951,2855,96,2
18-12-2021,Ernakulam,19195,18684,511,23
18-12-2021,Thrissur,4089,3930,159,19
18-12-2021,Palakkad,9475,9400,75,13
18-12-2021,Malappuram,10087,9933,154,13
18-12-2021,Kozhikode,16367,16118,249,16
18-12-2021,Wayanad,9710,9648,62,10
18-12-2021,Kannur,7972,7828,144,23
18-12-2021,Kasaragod,5097,4838,259,6
18-12-2021,total,141586,137745,3841,209
17-12-2021,Thiruvananthapuram,27709,26440,1269,30
17-12-2021,Kollam,8528,8292,236,21
17-12-2021,Pathanamthitta,4593,4231,362,3
17-12-2021,Alappuzha,4222,4172,50,1
17-12-2021,Kottayam,12548,12203,345,3
17-12-2021,Idukki,2914,2815,99,1
17-12-2021,Ernakulam,19726,19211,515,11
17-12-2021,Thrissur,4173,3996,177,27
17-12-2021,Palakkad,8922,8851,71,7
17-12-2021,Malappuram,10201,10033,168,10
17-12-2021,Kozhikode,16513,16260,253,10
17-12-2021,Wayanad,10143,10079,64,13
17-12-2021,Kannur,8158,8002,156,22
17-12-2021,Kasaragod,4987,4733,254,9
17-12-2021,total,143337,139318,4019,168
16-12-2021,Thiruvananthapuram,28633,27364,1269,30
16-12-2021,Kollam,8541,8310,231,30
16-12-2021,Pathanamthitta,3928,3527,401,7
16-12-2021,Alappuzha,3940,3888,52,11
16-12-2021,Kottayam,14291,13945,346,10
16-12-2021,Idukki,2981,2882,99,3
16-12-2021,Ernakulam,21053,20524,529,19
16-12-2021,Thrissur,4207,4032,175,31
16-12-2021,Palakkad,9629,9553,76,7
16-12-2021,Malappuram,10401,10228,173,11
16-12-2021,Kozhikode,16712,16451,261,9
16-12-2021,Wayanad,9834,9765,69,10
16-12-2021,Kannur,8112,7947,165,25
16-12-2021,Kasaragod,4942,4694,248,3
16-12-2021,total,147204,143110,4094,206
15-12-2021,Thiruvananthapuram,28963,27694,1269,30
15-12-2021,Kollam,8266,8016,250,21
15-12-2021,Pathanamthitta,3650,3238,412,10
15-12-2021,Alappuzha,3490,3439,51,11
15-12-2021,Kottayam,16024,15688,336,2
15-12-2021,Idukki,2974,2879,95,3
15-12-2021,Ernakulam,21758,21230,528,15
15-12-2021,Thrissur,4377,4200,177,37
15-12-2021,Palakkad,9725,9658,67,8
15-12-2021,Malappuram,10488,10312,176,11
15-12-2021,Kozhikode,17002,16756,246,18
15-12-2021,Wayanad,10109,10038,71,12
15-12-2021,Kannur,8070,7903,167,21
15-12-2021,Kasaragod,4732,4485,247,4
15-12-2021,total,149628,145536,4092,203
12-12-2021,Thiruvananthapuram,29602,28333,1269,30
12-12-2021,Kollam,8783,8500,283,21
12-12-2021,Pathanamthitta,2794,2389,405,5
12-12-2021,Alappuzha,3272,3216,56,5
12-12-2021,Kottayam,19316,18988,328,5
12-12-2021,Idukki,5472,5370,102,2
12-12-2021,Ernakulam,22913,22372,541,7
12-12-2021,Thrissur,5007,4824,183,15
12-12-2021,Palakkad,12473,12335,138,22
12-12-2021,Malappuram,10639,10467,172,16
12-12-2021,Kozhikode,17952,17674,278,14
12-12-2021,Wayanad,11344,11254,90,12
12-12-2021,Kannur,7911,7690,221,35
12-12-2021,Kasaragod,4433,4165,268,7
12-12-2021,total,161911,157577,4334,196
11-12-2021,Thiruvananthapuram,29153,27884,1269,
11-12-2021,Kollam,8719,8421,298,31
11-12-2021,Pathanamthitta,3107,2691,416,6
11-12-2021,Alappuzha,3323,3268,55,4
11-12-2021,Kottayam,20067,19726,341,7
11-12-2021,Idukki,2721,2623,98,3
11-12-2021,Ernakulam,23713,23131,582,23
11-12-2021,Thrissur,4935,4735,200,34
11-12-2021,Palakkad,12646,12506,140,8
11-12-2021,Malappuram,10633,10446,187,13
11-12-2021,Kozhikode,19096,18823,273,15
11-12-2021,Wayanad,11635,11533,102,16
11-12-2021,Kannur,7885,7604,281,28
11-12-2021,Kasaragod,4306,4034,272,18
11-12-2021,total,161939,157425,4514,206
21-12-2021,Thiruvananthapuram,26292,25023,1269,30
21-12-2021,Kollam,6851,6601,250,27
21-12-2021,Pathanamthitta,5384,5183,201,6
21-12-2021,Alappuzha,3994,3949,45,6
21-12-2021,Kottayam,13324,12991,333,0
21-12-2021,Idukki,2687,2597,90,5
21-12-2021,Ernakulam,17020,16513,507,15
21-12-2021,Thrissur,4132,3640,492,21
21-12-2021,Palakkad,8941,8862,79,8
21-12-2021,Malappuram,9262,9113,149,10
21-12-2021,Kozhikode,16019,15777,242,19
21-12-2021,Wayanad,9859,9796,63,6
21-12-2021,Kannur,7931,7772,159,24
21-12-2021,Kasaragod,5168,4914,254,7
21-12-2021,total,136864,132731,4133,184
22-12-2021,Thiruvananthapuram,25854,24617,1237,27
22-12-2021,Kollam,6545,6308,237,21
22-12-2021,Pathanamthitta,5702,5538,164,6
22-12-2021,Alappuzha,3907,3860,47,8
22-12-2021,Kottayam,13567,13249,318,0
22-12-2021,Idukki,2613,2528,85,1
22-12-2021,Ernakulam,15941,15451,490,24
22-12-2021,Thrissur,4078,3586,492,23
22-12-2021,Palakkad,8777,8697,80,9
22-12-2021,Malappuram,9273,9116,157,10
22-12-2021,Kozhikode,15883,15634,249,23
22-12-2021,Wayanad,8768,8694,74,16
22-12-2021,Kannur,7848,7715,133,20
22-12-2021,Kasaragod,5390,5133,257,5
22-12-2021,total,134146,130126,4020,193
23-12-2021,Thiruvananthapuram,25257,24020,1237,27
23-12-2021,Kollam,6331,6108,223,14
23-12-2021,Pathanamthitta,5965,5796,169,12
23-12-2021,Alappuzha,3802,3746,56,8
23-12-2021,Kottayam,12969,12670,299,4
23-12-2021,Idukki,2452,2364,88,3
23-12-2021,Ernakulam,15406,14926,480,8
23-12-2021,Thrissur,3953,3465,488,25
23-12-2021,Palakkad,8689,8630,59,5
23-12-2021,Malappuram,9255,9103,152,14
23-12-2021,Kozhikode,15463,15215,248,21
23-12-2021,Wayanad,8832,8769,63,4
23-12-2021,Kannur,7864,7736,128,30
23-12-2021,Kasaragod,5107,4849,258,3
23-12-2021,total,131345,127397,3948,178
24-12-2021,Thiruvananthapuram,24791,23563,1228,34
24-12-2021,Kollam,6052,5825,227,22
24-12-2021,Pathanamthitta,6109,5942,167,5
24-12-2021,Alappuzha,3822,3756,66,13
24-12-2021,Kottayam,13335,13045,290,9
24-12-2021,Idukki,2402,2310,92,4
24-12-2021,Ernakulam,14361,13902,459,21
24-12-2021,Thrissur,3821,3344,477,16
24-12-2021,Palakkad,8426,8368,58,6
24-12-2021,Malappuram,9037,8877,160,12
24-12-2021,Kozhikode,15756,15527,229,29
24-12-2021,Wayanad,8982,8921,61,11
24-12-2021,Kannur,7699,7578,121,27
24-12-2021,Kasaragod,4908,4647,261,4
24-12-2021,total,129501,125605,3896,213
26-12-2021,Thiruvananthapuram,22936,21708,1228,34
26-12-2021,Kollam,5476,5256,220,18
26-12-2021,Pathanamthitta,6067,5909,158,6
26-12-2021,Alappuzha,3502,3438,64,4
26-12-2021,Kottayam,12559,12257,302,3
26-12-2021,Idukki,1917,1832,85,1
26-12-2021,Ernakulam,13446,13003,443,4
26-12-2021,Thrissur,2886,2403,483,9
26-12-2021,Palakkad,7867,7800,67,6
26-12-2021,Malappuram,8752,8589,163,12
26-12-2021,Kozhikode,14756,14529,227,21
26-12-2021,Wayanad,9234,9178,56,5
26-12-2021,Kannur,7579,7469,110,15
26-12-2021,Kasaragod,4532,4266,266,4
26-12-2021,total,121509,117637,3872,142
25-12-2021,Thiruvananthapuram,23926,22698,1228,34
25-12-2021,Kollam,5597,5376,221,17
25-12-2021,Pathanamthitta,5997,5855,142,3
25-12-2021,Alappuzha,3578,3514,64,3
25-12-2021,Kottayam,12806,12501,305,1
25-12-2021,Idukki,2172,2081,91,3
25-12-2021,Ernakulam,13721,13278,443,12
25-12-2021,Thrissur,3309,2827,482,21
25-12-2021,Palakkad,8183,8122,61,7
25-12-2021,Malappuram,9003,8847,156,11
25-12-2021,Kozhikode,15187,14959,228,18
25-12-2021,Wayanad,9019,8960,59,9
25-12-2021,Kannur,7646,7531,115,22
25-12-2021,Kasaragod,4760,4497,263,2
25-12-2021,total,124904,121046,3858,163
27-12-2021,Thiruvananthapuram,22519,21291,1228,34
27-12-2021,Kollam,5179,4970,209,14
27-12-2021,Pathanamthitta,5943,5788,155,0
27-12-2021,Alappuzha,3398,3331,67,6
27-12-2021,Kottayam,12202,11908,294,0
27-12-2021,Idukki,1835,1773,62,1
27-12-2021,Ernakulam,11948,11516,432,3
27-12-2021,Thrissur,2766,2275,491,23
27-12-2021,Palakkad,8387,8318,69,5
27-12-2021,Malappuram,8444,8286,158,11
27-12-2021,Kozhikode,14989,14768,221,4
27-12-2021,Wayanad,9493,9445,48,5
27-12-2021,Kannur,7524,7382,142,25
27-12-2021,Kasaragod,4398,4131,267,1
27-12-2021,total,119025,115182,3843,132
28-12-2021,Thiruvananthapuram,22054,20826,1228,34
28-12-2021,Kollam,5144,4956,188,15
28-12-2021,Pathanamthitta,6003,5854,149,5
28-12-2021,Alappuzha,3316,3254,62,9
28-12-2021,Kottayam,11718,11430,288,0
28-12-2021,Idukki,1805,1755,50,4
28-12-2021,Ernakulam,11648,11205,443,33
28-12-2021,Thrissur,2708,2216,492,32
28-12-2021,Palakkad,8359,8284,75,7
28-12-2021,Malappuram,8358,8211,147,7
28-12-2021,Kozhikode,15093,14894,199,18
28-12-2021,Wayanad,8474,8427,47,6
28-12-2021,Kannur,7347,7207,140,23
28-12-2021,Kasaragod,4351,4122,229,4
28-12-2021,total,116378,112641,3737,197
29-12-2021,Thiruvananthapuram,21410,20182,1228,34
29-12-2021,Kollam,4610,4424,186,17
29-12-2021,Pathanamthitta,6040,5890,150,9
29-12-2021,Alappuzha,3243,3180,63,6
29-12-2021,Kottayam,11730,11455,275,275
29-12-2021,Idukki,1644,1598,46,3
29-12-2021,Ernakulam,11495,11063,432,13
29-12-2021,Thrissur,2788,2303,485,26
29-12-2021,Palakkad,7041,6969,72,5
29-12-2021,Malappuram,8270,8134,136,10
29-12-2021,Kozhikode,14996,14805,191,11
29-12-2021,Wayanad,7656,7603,53,11
29-12-2021,Kannur,7239,7100,139,19
29-12-2021,Kasaragod,4122,3887,235,8
29-12-2021,total,112284,108593,3691,447
30-12-2021,Thiruvananthapuram,20154,18929,1225,31
30-12-2021,Kollam,4336,4154,182,10
30-12-2021,Pathanamthitta,6062,5909,153,13
30-12-2021,Alappuzha,3110,3048,62,6
30-12-2021,Kottayam,12760,12526,234,0
30-12-2021,Idukki,1555,1513,42,1
30-12-2021,Ernakulam,11219,10797,422,18
30-12-2021,Thrissur,2736,2245,491,28
30-12-2021,Palakkad,6701,6633,68,6
30-12-2021,Malappuram,8177,8049,128,8
30-12-2021,Kozhikode,14967,14761,206,18
30-12-2021,Wayanad,7572,7514,58,10
30-12-2021,Kannur,7165,7070,95,18
30-12-2021,Kasaragod,4166,3926,240,5
30-12-2021,total,110680,107074,3606,172
31-12-2021,Thiruvananthapuram,20383,19158,1225,31
31-12-2021,Kollam,4205,4039,166,14
31-12-2021,Pathanamthitta,6182,6046,136,4
31-12-2021,Alappuzha,2924,2858,66,9
31-12-2021,Kottayam,14165,13918,247,0
31-12-2021,Idukki,1520,1476,44,2
31-12-2021,Ernakulam,10926,10513,413,10
31-12-2021,Thrissur,2789,2297,492,22
31-12-2021,Palakkad,6546,6497,49,7
31-12-2021,Malappuram,8072,7950,122,9
31-12-2021,Kozhikode,15376,15182,194,22
31-12-2021,Wayanad,6896,6844,52,4
31-12-2021,Kannur,7113,7019,94,19
31-12-2021,Kasaragod,4013,3767,246,4
31-12-2021,total,111110,107564,3546,157
01-01-2022,Thiruvananthapuram,19849,6322,13527,31
01-01-2022,Kollam,3980,3800,180,18
01-01-2022,Pathanamthitta,6126,5971,155,7
01-01-2022,Alappuzha,2730,2658,72,9
01-01-2022,Kottayam,14044,13821,223,4
01-01-2022,Idukki,1616,1572,44,0
01-01-2022,Ernakulam,10586,10168,418,10
01-01-2022,Thrissur,2854,2357,497,20
01-01-2022,Palakkad,6491,6441,50,5
01-01-2022,Malappuram,7917,7784,133,13
01-01-2022,Kozhikode,14855,14676,179,23
01-01-2022,Wayanad,6975,6930,45,7
01-01-2022,Kannur,7078,6986,92,21
01-01-2022,Kasaragod,3931,3704,227,1
01-01-2022,total,109032,93190,15842,169
02-01-2022,Thiruvananthapuram,18887,17926,961,28
02-01-2022,Kollam,3874,3694,180,0
02-01-2022,Pathanamthitta,5736,5581,155,6
02-01-2022,Alappuzha,2612,2543,69,3
02-01-2022,Kottayam,13178,12953,225,7
02-01-2022,Idukki,1454,1411,43,1
02-01-2022,Ernakulam,9818,9392,426,25
02-01-2022,Thrissur,2879,2385,494,14
02-01-2022,Palakkad,6268,6216,52,7
02-01-2022,Malappuram,7944,7813,131,15
02-01-2022,Kozhikode,14450,14253,197,19
02-01-2022,Wayanad,6972,6930,42,6
02-01-2022,Kannur,7019,6927,92,16
02-01-2022,Kasaragod,3866,3658,208,2
02-01-2022,total,104957,101682,3275,149
03-01-2022,Thiruvananthapuram,19423,19144,279,42
03-01-2022,Kollam,3514,3330,184,20
03-01-2022,Pathanamthitta,5713,5566,147,0
03-01-2022,Alappuzha,2183,2106,77,6
03-01-2022,Kottayam,13443,13210,233,0
03-01-2022,Idukki,1486,1447,39,1
03-01-2022,Ernakulam,9349,8960,389,5
03-01-2022,Thrissur,2815,2676,139,26
03-01-2022,Palakkad,6508,6453,55,9
03-01-2022,Malappuram,7889,7756,133,16
03-01-2022,Kozhikode,14226,14029,197,13
03-01-2022,Wayanad,6921,6877,44,10
03-01-2022,Kannur,7018,6918,100,18
03-01-2022,Kasaragod,4018,3809,209,1
03-01-2022,total,104506,102281,2225,167
04-01-2022,Thiruvananthapuram,20575,20170,405,42
04-01-2022,Kollam,3814,3631,183,10
04-01-2022,Pathanamthitta,5890,5737,153,1
04-01-2022,Alappuzha,1992,1912,80,8
04-01-2022,Kottayam,12647,12409,238,0
04-01-2022,Idukki,1576,1534,42,3
04-01-2022,Ernakulam,9504,9087,417,48
04-01-2022,Thrissur,2788,2656,132,20
04-01-2022,Palakkad,5747,5694,53,9
04-01-2022,Malappuram,8148,8021,127,0
04-01-2022,Kozhikode,14883,14700,183,17
04-01-2022,Wayanad,6941,6903,38,4
04-01-2022,Kannur,6982,6888,94,16
04-01-2022,Kasaragod,4060,3851,209,2
04-01-2022,total,105547,103193,2354,180
05-01-2022,Thiruvananthapuram,20039,19625,414,61
05-01-2022,Kollam,3701,3537,164,19
05-01-2022,Pathanamthitta,5990,5845,145,4
05-01-2022,Alappuzha,1966,1884,82,14
05-01-2022,Kottayam,11990,11762,228,0
05-01-2022,Idukki,1788,1737,51,5
05-01-2022,Ernakulam,10131,9729,402,28
05-01-2022,Thrissur,2786,2656,130,17
05-01-2022,Palakkad,5177,5126,51,7
05-01-2022,Malappuram,8211,8070,141,17
05-01-2022,Kozhikode,14937,14736,201,26
05-01-2022,Wayanad,6473,6443,30,3
05-01-2022,Kannur,7086,6991,95,19
05-01-2022,Kasaragod,4078,3866,212,5
05-01-2022,total,104353,102007,2346,225
