date,district,deaths_reported,death_through_appeal,pending_deaths,death_cases_approved
22-10-2021,Thiruvananthapuram,10,1,289,300
22-10-2021,Kollam,8,0,0,8
22-10-2021,Pathanamthitta,9,2,0,11
22-10-2021,Alappuzha,2,1,0,3
22-10-2021,Kottayam,4,0,0,4
22-10-2021,Idukki,9,12,0,21
22-10-2021,Ernakulam,8,45,0,53
22-10-2021,Thrissur,4,36,0,40
22-10-2021,Palakkad,9,30,0,39
22-10-2021,Malappuram,6,6,0,12
22-10-2021,Kozhikode,6,0,2,8
22-10-2021,Wayanad,0,1,0,1
22-10-2021,Kannur,23,36,0,59
22-10-2021,Kasaragod,1,2,1,4
22-10-2021,total,99,172,292,563
23-10-2021,Thiruvananthapuram,8,0,225,233
23-10-2021,Kollam,1,13,0,14
23-10-2021,Pathanamthitta,6,18,2,26
23-10-2021,Alappuzha,0,12,0,12
23-10-2021,Kottayam,5,0,0,5
23-10-2021,Idukki,0,0,10,10
23-10-2021,Ernakulam,9,57,0,66
23-10-2021,Thrissur,7,0,0,7
23-10-2021,Palakkad,6,0,0,6
23-10-2021,Malappuram,4,14,0,18
23-10-2021,Kozhikode,13,0,1,14
23-10-2021,Wayanad,0,4,19,23
23-10-2021,Kannur,6,19,0,25
23-10-2021,Kasaragod,0,5,0,5
23-10-2021,total,65,142,257,464
24-10-2021,Thiruvananthapuram,5,0,132,137
24-10-2021,Kollam,25,0,19,44
24-10-2021,Pathanamthitta,0,0,11,11
24-10-2021,Alappuzha,0,0,5,5
24-10-2021,Kottayam,4,0,1,5
24-10-2021,Idukki,0,0,7,7
24-10-2021,Ernakulam,6,0,31,37
24-10-2021,Thrissur,8,0,0,8
24-10-2021,Palakkad,7,0,3,10
24-10-2021,Malappuram,5,15,0,20
24-10-2021,Kozhikode,8,0,0,8
24-10-2021,Wayanad,2,0,2,4
24-10-2021,Kannur,0,39,0,39
24-10-2021,Kasaragod,1,27,0,28
24-10-2021,total,71,81,211,363
25-10-2021,Thiruvananthapuram,1,0,29,30
25-10-2021,Kollam,2,0,3,5
25-10-2021,Pathanamthitta,8,0,57,65
25-10-2021,Alappuzha,2,0,37,39
25-10-2021,Kottayam,2,0,4,6
25-10-2021,Idukki,0,0,4,4
25-10-2021,Ernakulam,9,0,16,25
25-10-2021,Thrissur,8,0,11,19
25-10-2021,Palakkad,5,0,10,15
25-10-2021,Malappuram,3,8,3,14
25-10-2021,Kozhikode,5,0,1,6
25-10-2021,Wayanad,1,0,24,25
25-10-2021,Kannur,6,0,20,26
25-10-2021,Kasaragod,1,1,0,2
25-10-2021,total,53,9,219,281
26-10-2021,Thiruvananthapuram,5,0,42,47
26-10-2021,Kollam,4,0,2,6
26-10-2021,Pathanamthitta,5,0,3,8
26-10-2021,Alappuzha,3,0,17,20
26-10-2021,Kottayam,8,0,55,63
26-10-2021,Idukki,10,0,4,14
26-10-2021,Ernakulam,7,0,136,143
26-10-2021,Thrissur,13,17,76,106
26-10-2021,Palakkad,19,30,3,52
26-10-2021,Malappuram,6,0,0,6
26-10-2021,Kozhikode,7,0,1,8
26-10-2021,Wayanad,2,0,1,3
26-10-2021,Kannur,1,0,0,1
26-10-2021,Kasaragod,0,4,1,5
26-10-2021,total,90,51,341,482
27-10-2021,Thiruvananthapuram,10,0,1,11
27-10-2021,Kollam,3,57,0,60
27-10-2021,Pathanamthitta,1,0,0,1
27-10-2021,Alappuzha,13,10,0,23
27-10-2021,Kottayam,5,0,0,5
27-10-2021,Idukki,0,0,0,0
27-10-2021,Ernakulam,9,0,90,99
27-10-2021,Thrissur,16,68,78,162
27-10-2021,Palakkad,8,0,23,31
27-10-2021,Malappuram,2,0,5,7
27-10-2021,Kozhikode,14,59,127,200
27-10-2021,Wayanad,0,0,0,0
27-10-2021,Kannur,12,0,6,18
27-10-2021,Kasaragod,0,5,0,5
27-10-2021,total,93,199,330,622
28-10-2021,Thiruvananthapuram,4,0,6,10
28-10-2021,Kollam,12,66,0,78
28-10-2021,Pathanamthitta,1,0,1,2
28-10-2021,Alappuzha,2,0,55,57
28-10-2021,Kottayam,5,0,0,5
28-10-2021,Idukki,0,23,0,23
28-10-2021,Ernakulam,13,0,11,24
28-10-2021,Thrissur,4,0,0,4
28-10-2021,Palakkad,7,0,39,46
28-10-2021,Malappuram,4,0,17,21
28-10-2021,Kozhikode,3,15,249,267
28-10-2021,Wayanad,1,0,1,2
28-10-2021,Kannur,0,0,163,163
28-10-2021,Kasaragod,0,6,0,6
28-10-2021,total,56,110,542,708
29-10-2021,Thiruvananthapuram,14,0,0,14
29-10-2021,Kollam,3,0,0,3
29-10-2021,Pathanamthitta,5,34,0,39
29-10-2021,Alappuzha,6,47,0,53
29-10-2021,Kottayam,7,0,1,8
29-10-2021,Idukki,9,20,0,29
29-10-2021,Ernakulam,13,0,191,204
29-10-2021,Thrissur,5,0,6,11
29-10-2021,Palakkad,10,0,0,10
29-10-2021,Malappuram,3,0,0,3
29-10-2021,Kozhikode,6,0,0,6
29-10-2021,Wayanad,0,0,0,0
29-10-2021,Kannur,5,6,70,81
29-10-2021,Kasaragod,0,2,8,10
29-10-2021,total,86,109,276,471
30-10-2021,Thiruvananthapuram,5,0,0,5
30-10-2021,Kollam,9,0,0,9
30-10-2021,Pathanamthitta,4,0,1,5
30-10-2021,Alappuzha,1,34,0,35
30-10-2021,Kottayam,9,0,0,9
30-10-2021,Idukki,0,0,0,0
30-10-2021,Ernakulam,7,0,229,236
30-10-2021,Thrissur,5,0,22,27
30-10-2021,Palakkad,5,0,0,5
30-10-2021,Malappuram,7,0,2,9
30-10-2021,Kozhikode,3,0,0,3
30-10-2021,Wayanad,0,0,0,0
30-10-2021,Kannur,7,5,0,12
30-10-2021,Kasaragod,0,0,3,3
30-10-2021,total,62,39,257,358
31-10-2021,Thiruvananthapuram,1,0,0,1
31-10-2021,Kollam,0,0,0,0
31-10-2021,Pathanamthitta,0,0,2,2
31-10-2021,Alappuzha,0,0,1,1
31-10-2021,Kottayam,5,0,0,5
31-10-2021,Idukki,0,0,1,1
31-10-2021,Ernakulam,4,0,7,11
31-10-2021,Thrissur,0,0,59,59
31-10-2021,Palakkad,1,0,15,16
31-10-2021,Malappuram,0,0,48,48
31-10-2021,Kozhikode,3,7,13,23
31-10-2021,Wayanad,0,0,0,0
31-10-2021,Kannur,0,0,0,0
31-10-2021,Kasaragod,0,0,0,0
31-10-2021,total,14,7,146,167
02-11-2021,Thiruvananthapuram,4,0,0,4
02-11-2021,Kollam,7,0,0,7
02-11-2021,Pathanamthitta,0,0,0,0
02-11-2021,Alappuzha,2,0,0,2
02-11-2021,Kottayam,1,0,0,1
02-11-2021,Idukki,0,0,0,0
02-11-2021,Ernakulam,8,55,35,98
02-11-2021,Thrissur,4,0,3,7
02-11-2021,Palakkad,4,0,10,14
02-11-2021,Malappuram,5,0,7,12
02-11-2021,Kozhikode,8,0,0,8
02-11-2021,Wayanad,2,0,0,2
02-11-2021,Kannur,0,0,31,31
02-11-2021,Kasaragod,0,0,1,1
02-11-2021,total,45,55,87,187
03-11-2021,Thiruvananthapuram,5,26,0,31
03-11-2021,Kollam,3,56,0,59
03-11-2021,Pathanamthitta,4,0,0,4
03-11-2021,Alappuzha,3,0,0,3
03-11-2021,Kottayam,0,0,0,0
03-11-2021,Idukki,3,13,0,16
03-11-2021,Ernakulam,8,0,52,60
03-11-2021,Thrissur,5,139,0,144
03-11-2021,Palakkad,12,1,0,13
03-11-2021,Malappuram,5,0,5,10
03-11-2021,Kozhikode,3,0,0,3
03-11-2021,Wayanad,0,0,0,0
03-11-2021,Kannur,0,0,8,8
03-11-2021,Kasaragod,0,4,7,11
03-11-2021,total,51,239,72,362
04-11-2021,Thiruvananthapuram,1,0,0,1
04-11-2021,Kollam,1,53,0,54
04-11-2021,Pathanamthitta,2,0,0,2
04-11-2021,Alappuzha,0,3,0,3
04-11-2021,Kottayam,14,0,0,14
04-11-2021,Idukki,0,0,0,0
04-11-2021,Ernakulam,7,0,13,20
04-11-2021,Thrissur,0,0,0,0
04-11-2021,Palakkad,14,0,0,14
04-11-2021,Malappuram,4,0,1,5
04-11-2021,Kozhikode,6,0,0,6
04-11-2021,Wayanad,4,0,0,4
04-11-2021,Kannur,0,0,0,0
04-11-2021,Kasaragod,2,4,7,13
04-11-2021,total,55,60,21,136
05-11-2021,Thiruvananthapuram,4,0,0,4
05-11-2021,Kollam,6,0,0,6
05-11-2021,Pathanamthitta,2,0,0,2
05-11-2021,Alappuzha,5,25,0,30
05-11-2021,Kottayam,0,0,0,0
05-11-2021,Idukki,7,0,0,7
05-11-2021,Ernakulam,10,1,89,100
05-11-2021,Thrissur,4,0,31,35
05-11-2021,Palakkad,0,0,4,4
05-11-2021,Malappuram,3,0,25,28
05-11-2021,Kozhikode,4,64,0,68
05-11-2021,Wayanad,0,0,0,0
05-11-2021,Kannur,0,16,5,21
05-11-2021,Kasaragod,1,5,3,9
05-11-2021,total,46,111,157,314
06-11-2021,Thiruvananthapuram,6,0,0,6
06-11-2021,Kollam,21,73,0,94
06-11-2021,Pathanamthitta,3,60,0,63
06-11-2021,Alappuzha,0,29,0,29
06-11-2021,Kottayam,5,35,0,40
06-11-2021,Idukki,0,0,0,0
06-11-2021,Ernakulam,7,26,105,138
06-11-2021,Thrissur,2,0,0,2
06-11-2021,Palakkad,3,6,0,9
06-11-2021,Malappuram,2,0,20,22
06-11-2021,Kozhikode,1,0,60,61
06-11-2021,Wayanad,0,0,0,0
06-11-2021,Kannur,0,2,0,2
06-11-2021,Kasaragod,0,0,1,1
06-11-2021,total,50,231,186,467
07-11-2021,Thiruvananthapuram,4,0,0,4
07-11-2021,Kollam,2,0,0,2
07-11-2021,Pathanamthitta,0,0,0,0
07-11-2021,Alappuzha,0,0,0,0
07-11-2021,Kottayam,0,0,0,0
07-11-2021,Idukki,3,0,0,3
07-11-2021,Ernakulam,6,0,7,13
07-11-2021,Thrissur,0,0,0,0
07-11-2021,Palakkad,2,21,0,23
07-11-2021,Malappuram,1,0,0,1
07-11-2021,Kozhikode,1,6,84,91
07-11-2021,Wayanad,2,0,0,2
07-11-2021,Kannur,0,0,43,43
07-11-2021,Kasaragod,0,0,19,19
07-11-2021,total,21,27,153,201
12-11-2021,Thiruvananthapuram,5,40,0,45
12-11-2021,Kollam,11,83,0,94
12-11-2021,Pathanamthitta,13,0,0,13
12-11-2021,Alappuzha,0,30,0,30
12-11-2021,Kottayam,14,0,0,14
12-11-2021,Idukki,0,8,0,8
12-11-2021,Ernakulam,10,139,0,149
12-11-2021,Thrissur,1,81,0,82
12-11-2021,Palakkad,1,0,0,1
12-11-2021,Malappuram,0,4,0,4
12-11-2021,Kozhikode,4,22,0,26
12-11-2021,Wayanad,0,0,0,0
12-11-2021,Kannur,0,0,0,0
12-11-2021,Kasaragod,0,5,0,5
12-11-2021,total,59,412,0,471
13-11-2021,Thiruvananthapuram,8,21,0,29
13-11-2021,Kollam,0,47,0,47
13-11-2021,Pathanamthitta,0,59,0,59
13-11-2021,Alappuzha,0,18,0,18
13-11-2021,Kottayam,0,0,0,0
13-11-2021,Idukki,0,0,0,0
13-11-2021,Ernakulam,4,5,0,9
13-11-2021,Thrissur,1,0,0,1
13-11-2021,Palakkad,9,0,0,9
13-11-2021,Malappuram,0,1,0,1
13-11-2021,Kozhikode,1,0,0,1
13-11-2021,Wayanad,0,0,0,0
13-11-2021,Kannur,0,0,0,0
13-11-2021,Kasaragod,0,0,0,0
13-11-2021,total,23,151,0,174
16-11-2021,Thiruvananthapuram,6,16,0,22
16-11-2021,Kollam,6,86,0,92
16-11-2021,Pathanamthitta,5,0,0,5
16-11-2021,Alappuzha,1,15,0,16
16-11-2021,Kottayam,2,0,0,2
16-11-2021,Idukki,0,6,0,6
16-11-2021,Ernakulam,7,0,0,7
16-11-2021,Thrissur,2,0,0,2
16-11-2021,Palakkad,0,2,0,2
16-11-2021,Malappuram,2,0,0,2
16-11-2021,Kozhikode,3,0,0,3
16-11-2021,Wayanad,2,32,0,34
16-11-2021,Kannur,0,0,0,0
16-11-2021,Kasaragod,3,14,0,17
16-11-2021,total,39,171,0,210
17-11-2021,Thiruvananthapuram,17,5,0,22
17-11-2021,Kollam,6,84,0,90
17-11-2021,Pathanamthitta,11,45,0,56
17-11-2021,Alappuzha,0,21,0,21
17-11-2021,Kottayam,0,0,0,0
17-11-2021,Idukki,0,9,0,9
17-11-2021,Ernakulam,10,45,0,55
17-11-2021,Thrissur,6,79,0,85
17-11-2021,Palakkad,3,14,0,17
17-11-2021,Malappuram,1,23,0,24
17-11-2021,Kozhikode,3,0,0,3
17-11-2021,Wayanad,3,0,0,3
17-11-2021,Kannur,0,0,0,0
17-11-2021,Kasaragod,1,2,0,3
17-11-2021,total,61,327,0,388
21-11-2021,Thiruvananthapuram,11,11,0,22
21-11-2021,Kollam,3,78,0,81
21-11-2021,Pathanamthitta,13,45,0,58
21-11-2021,Alappuzha,0,0,0,0
21-11-2021,Kottayam,8,0,0,8
21-11-2021,Idukki,0,0,0,0
21-11-2021,Ernakulam,0,0,0,0
21-11-2021,Thrissur,0,0,0,0
21-11-2021,Palakkad,4,9,0,13
21-11-2021,Malappuram,0,0,0,0
21-11-2021,Kozhikode,0,3,0,3
21-11-2021,Wayanad,1,0,0,1
21-11-2021,Kannur,0,1,0,1
21-11-2021,Kasaragod,0,9,0,9
21-11-2021,total,40,156,0,196
23-11-2021,Thiruvananthapuram,18,11,0,29
23-11-2021,Kollam,11,133,0,144
23-11-2021,Pathanamthitta,0,45,0,45
23-11-2021,Alappuzha,0,27,0,27
23-11-2021,Kottayam,0,25,0,25
23-11-2021,Idukki,0,0,0,0
23-11-2021,Ernakulam,5,31,0,36
23-11-2021,Thrissur,8,0,0,8
23-11-2021,Palakkad,6,30,0,36
23-11-2021,Malappuram,7,0,0,7
23-11-2021,Kozhikode,2,0,0,2
23-11-2021,Wayanad,0,10,0,10
23-11-2021,Kannur,0,1,0,1
23-11-2021,Kasaragod,0,0,0,0
23-11-2021,total,57,313,0,370
25-11-2021,Thiruvananthapuram,13,33,0,46
25-11-2021,Kollam,9,0,0,9
25-11-2021,Pathanamthitta,7,0,0,7
25-11-2021,Alappuzha,1,28,0,29
25-11-2021,Kottayam,6,78,0,84
25-11-2021,Idukki,6,21,0,27
25-11-2021,Ernakulam,8,10,0,18
25-11-2021,Thrissur,1,0,0,1
25-11-2021,Palakkad,4,11,0,15
25-11-2021,Malappuram,0,0,0,0
25-11-2021,Kozhikode,1,69,0,70
25-11-2021,Wayanad,0,0,0,0
25-11-2021,Kannur,0,78,0,78
25-11-2021,Kasaragod,0,0,0,0
25-11-2021,total,56,328,0,384
26-11-2021,Thiruvananthapuram,5,35,0,40
26-11-2021,Kollam,5,0,0,5
26-11-2021,Pathanamthitta,0,1,0,1
26-11-2021,Alappuzha,2,15,0,17
26-11-2021,Kottayam,0,58,0,58
26-11-2021,Idukki,0,10,0,10
26-11-2021,Ernakulam,4,5,0,9
26-11-2021,Thrissur,4,113,0,117
26-11-2021,Palakkad,8,25,0,33
26-11-2021,Malappuram,3,31,0,34
26-11-2021,Kozhikode,2,0,0,2
26-11-2021,Wayanad,0,0,0,0
26-11-2021,Kannur,0,62,0,62
26-11-2021,Kasaragod,0,0,0,0
26-11-2021,total,33,355,0,388
27-11-2021,Thiruvananthapuram,6,9,0,15
27-11-2021,Kollam,6,156,0,162
27-11-2021,Pathanamthitta,0,43,0,43
27-11-2021,Alappuzha,0,31,0,31
27-11-2021,Kottayam,0,60,0,60
27-11-2021,Idukki,0,0,0,0
27-11-2021,Ernakulam,4,29,0,33
27-11-2021,Thrissur,3,103,0,106
27-11-2021,Palakkad,4,19,0,23
27-11-2021,Malappuram,0,50,0,50
27-11-2021,Kozhikode,3,0,0,3
27-11-2021,Wayanad,2,3,0,5
27-11-2021,Kannur,0,17,0,17
27-11-2021,Kasaragod,0,6,0,6
27-11-2021,total,28,526,0,554
29-11-2021,Thiruvananthapuram,7,16,0,23
29-11-2021,Kollam,3,0,0,3
29-11-2021,Pathanamthitta,0,0,0,0
29-11-2021,Alappuzha,3,21,0,24
29-11-2021,Kottayam,17,0,0,17
29-11-2021,Idukki,0,0,0,0
29-11-2021,Ernakulam,3,0,0,3
29-11-2021,Thrissur,8,0,0,8
29-11-2021,Palakkad,1,0,0,1
29-11-2021,Malappuram,9,0,0,9
29-11-2021,Kozhikode,5,0,0,5
29-11-2021,Wayanad,3,0,0,3
29-11-2021,Kannur,0,21,0,21
29-11-2021,Kasaragod,0,0,0,0
29-11-2021,total,59,58,0,117
30-11-2021,Thiruvananthapuram,3,28,0,31
30-11-2021,Kollam,5,0,0,5
30-11-2021,Pathanamthitta,0,79,0,79
30-11-2021,Alappuzha,0,21,0,21
30-11-2021,Kottayam,0,0,0,0
30-11-2021,Idukki,0,12,0,12
30-11-2021,Ernakulam,0,0,0,0
30-11-2021,Thrissur,7,0,0,7
30-11-2021,Palakkad,0,2,0,2
30-11-2021,Malappuram,2,0,0,2
30-11-2021,Kozhikode,0,0,0,0
30-11-2021,Wayanad,0,0,0,0
30-11-2021,Kannur,0,9,0,9
30-11-2021,Kasaragod,2,7,0,9
30-11-2021,total,19,158,0,177
01-12-2021,Thiruvananthapuram,7,38,0,45
01-12-2021,Kollam,8,185,0,193
01-12-2021,Pathanamthitta,7,0,0,7
01-12-2021,Alappuzha,5,6,0,11
01-12-2021,Kottayam,0,0,0,0
01-12-2021,Idukki,5,18,0,23
01-12-2021,Ernakulam,4,0,0,4
01-12-2021,Thrissur,6,0,0,6
01-12-2021,Palakkad,3,11,0,14
01-12-2021,Malappuram,14,0,0,14
01-12-2021,Kozhikode,4,0,0,4
01-12-2021,Wayanad,2,0,0,2
01-12-2021,Kannur,31,41,0,72
01-12-2021,Kasaragod,0,8,0,8
01-12-2021,total,96,307,0,403
02-12-2021,Thiruvananthapuram,6,44,0,50
02-12-2021,Kollam,4,0,0,4
02-12-2021,Pathanamthitta,2,0,0,2
02-12-2021,Alappuzha,2,6,0,8
02-12-2021,Kottayam,11,0,0,11
02-12-2021,Idukki,1,22,0,23
02-12-2021,Ernakulam,12,0,0,12
02-12-2021,Thrissur,4,83,0,87
02-12-2021,Palakkad,0,31,0,31
02-12-2021,Malappuram,9,0,0,9
02-12-2021,Kozhikode,0,0,0,0
02-12-2021,Wayanad,0,0,0,0
02-12-2021,Kannur,15,60,0,75
02-12-2021,Kasaragod,0,8,0,8
02-12-2021,total,66,254,0,320
03-12-2021,Thiruvananthapuram,6,26,0,32
03-12-2021,Kollam,8,,0,8
03-12-2021,Pathanamthitta,3,,0,3
03-12-2021,Alappuzha,0,23,0,23
03-12-2021,Kottayam,9,,0,9
03-12-2021,Idukki,0,2,0,2
03-12-2021,Ernakulam,5,21,0,26
03-12-2021,Thrissur,1,69,0,70
03-12-2021,Palakkad,9,41,0,50
03-12-2021,Malappuram,0,1,0,1
03-12-2021,Kozhikode,1,38,0,39
03-12-2021,Wayanad,2,2,0,4
03-12-2021,Kannur,0,2,0,2
03-12-2021,Kasaragod,0,,0,0
03-12-2021,total,44,225,0,269
05-12-2021,Thiruvananthapuram,4,28,0,32
05-12-2021,Kollam,4,11,0,15
05-12-2021,Pathanamthitta,0,0,0,0
05-12-2021,Alappuzha,0,14,0,14
05-12-2021,Kottayam,3,0,0,3
05-12-2021,Idukki,0,0,0,0
05-12-2021,Ernakulam,10,23,0,33
05-12-2021,Thrissur,0,0,0,0
05-12-2021,Palakkad,1,52,0,53
05-12-2021,Malappuram,0,0,0,0
05-12-2021,Kozhikode,0,0,0,0
05-12-2021,Wayanad,1,0,0,1
05-12-2021,Kannur,0,0,0,0
05-12-2021,Kasaragod,0,10,0,10
05-12-2021,total,23,138,0,161
07-12-2021,Thiruvananthapuram,7,13,0,20
07-12-2021,Kollam,7,0,0,7
07-12-2021,Pathanamthitta,2,0,0,2
07-12-2021,Alappuzha,0,1,0,1
07-12-2021,Kottayam,0,59,0,59
07-12-2021,Idukki,2,0,0,2
07-12-2021,Ernakulam,0,0,0,0
07-12-2021,Thrissur,3,0,0,3
07-12-2021,Palakkad,1,28,0,29
07-12-2021,Malappuram,0,0,0,0
07-12-2021,Kozhikode,3,0,0,3
07-12-2021,Wayanad,0,0,0,0
07-12-2021,Kannur,0,0,0,0
07-12-2021,Kasaragod,3,5,0,8
07-12-2021,total,28,106,0,134
09-12-2021,Thiruvananthapuram,7,31,0,38
09-12-2021,Kollam,8,0,0,8
09-12-2021,Pathanamthitta,2,68,0,70
09-12-2021,Alappuzha,6,8,0,14
09-12-2021,Kottayam,4,34,0,38
09-12-2021,Idukki,7,0,0,7
09-12-2021,Ernakulam,5,0,0,5
09-12-2021,Thrissur,3,0,0,3
09-12-2021,Palakkad,4,16,0,20
09-12-2021,Malappuram,2,10,0,12
09-12-2021,Kozhikode,0,0,0,0
09-12-2021,Wayanad,2,0,0,2
09-12-2021,Kannur,1,0,0,1
09-12-2021,Kasaragod,1,6,0,7
09-12-2021,total,52,173,0,225
08-12-2021,Thiruvananthapuram,8,17,0,25
08-12-2021,Kollam,6,0,0,6
08-12-2021,Pathanamthitta,2,0,0,2
08-12-2021,Alappuzha,0,0,0,0
08-12-2021,Kottayam,3,30,0,33
08-12-2021,Idukki,0,0,0,0
08-12-2021,Ernakulam,6,0,0,6
08-12-2021,Thrissur,1,0,0,1
08-12-2021,Palakkad,6,30,0,36
08-12-2021,Malappuram,0,0,0,0
08-12-2021,Kozhikode,3,0,0,3
08-12-2021,Wayanad,0,0,0,0
08-12-2021,Kannur,0,0,0,0
08-12-2021,Kasaragod,0,0,0,0
08-12-2021,total,35,77,0,112
06-12-2021,Thiruvananthapuram,8,10,0,18
06-12-2021,Kollam,1,0,0,1
06-12-2021,Pathanamthitta,0,0,0,0
06-12-2021,Alappuzha,0,44,0,44
06-12-2021,Kottayam,0,42,0,42
06-12-2021,Idukki,0,14,0,14
06-12-2021,Ernakulam,5,0,0,5
06-12-2021,Thrissur,1,0,0,1
06-12-2021,Palakkad,7,11,0,18
06-12-2021,Malappuram,0,0,0,0
06-12-2021,Kozhikode,3,0,0,3
06-12-2021,Wayanad,3,0,0,3
06-12-2021,Kannur,0,0,0,0
06-12-2021,Kasaragod,2,17,0,19
06-12-2021,total,30,138,0,168
04-12-2021,Thiruvananthapuram,8,20,0,28
04-12-2021,Kollam,16,92,0,108
04-12-2021,Pathanamthitta,2,0,0,2
04-12-2021,Alappuzha,0,33,0,33
04-12-2021,Kottayam,8,0,0,8
04-12-2021,Idukki,0,0,0,0
04-12-2021,Ernakulam,5,38,0,43
04-12-2021,Thrissur,3,0,0,3
04-12-2021,Palakkad,4,40,0,44
04-12-2021,Malappuram,0,0,0,0
04-12-2021,Kozhikode,0,20,0,20
04-12-2021,Wayanad,3,16,0,19
04-12-2021,Kannur,0,1,0,1
04-12-2021,Kasaragod,3,3,0,6
04-12-2021,total,52,263,0,315
24-11-2021,Thiruvananthapuram,6,30,0,36
24-11-2021,Kollam,5,0,0,5
24-11-2021,Pathanamthitta,0,0,0,0
24-11-2021,Alappuzha,2,45,0,47
24-11-2021,Kottayam,7,79,0,86
24-11-2021,Idukki,2,7,0,9
24-11-2021,Ernakulam,3,57,0,60
24-11-2021,Thrissur,3,0,0,3
24-11-2021,Palakkad,0,22,0,22
24-11-2021,Malappuram,1,29,0,30
24-11-2021,Kozhikode,3,0,0,3
24-11-2021,Wayanad,2,0,0,2
24-11-2021,Kannur,0,0,0,0
24-11-2021,Kasaragod,1,4,0,5
24-11-2021,total,35,273,0,308
22-11-2021,Thiruvananthapuram,0,2,0,2
22-11-2021,Kollam,8,0,0,8
22-11-2021,Pathanamthitta,0,0,0,0
22-11-2021,Alappuzha,59,21,0,80
22-11-2021,Kottayam,0,0,0,0
22-11-2021,Idukki,0,0,0,0
22-11-2021,Ernakulam,2,39,0,41
22-11-2021,Thrissur,0,34,0,34
22-11-2021,Palakkad,1,0,0,1
22-11-2021,Malappuram,0,0,0,0
22-11-2021,Kozhikode,3,9,0,12
22-11-2021,Wayanad,2,0,0,2
22-11-2021,Kannur,0,0,0,0
22-11-2021,Kasaragod,0,0,0,0
22-11-2021,total,75,105,0,180
20-11-2021,Thiruvananthapuram,5,6,0,11
20-11-2021,Kollam,8,108,0,116
20-11-2021,Pathanamthitta,0,0,0,0
20-11-2021,Alappuzha,5,33,0,38
20-11-2021,Kottayam,0,0,0,0
20-11-2021,Idukki,0,4,0,4
20-11-2021,Ernakulam,2,0,0,2
20-11-2021,Thrissur,1,0,0,1
20-11-2021,Palakkad,4,9,0,13
20-11-2021,Malappuram,0,4,0,4
20-11-2021,Kozhikode,2,31,0,33
20-11-2021,Wayanad,5,0,0,5
20-11-2021,Kannur,0,21,0,21
20-11-2021,Kasaragod,0,0,0,0
20-11-2021,total,32,216,0,248
19-11-2021,Thiruvananthapuram,4,2,0,6
19-11-2021,Kollam,3,0,0,3
19-11-2021,Pathanamthitta,0,1,0,1
19-11-2021,Alappuzha,26,37,0,63
19-11-2021,Kottayam,0,0,0,0
19-11-2021,Idukki,0,7,0,7
19-11-2021,Ernakulam,10,0,0,10
19-11-2021,Thrissur,4,0,0,4
19-11-2021,Palakkad,0,1,0,1
19-11-2021,Malappuram,0,24,0,24
19-11-2021,Kozhikode,1,0,0,1
19-11-2021,Wayanad,1,0,0,1
19-11-2021,Kannur,0,79,0,79
19-11-2021,Kasaragod,0,4,0,4
19-11-2021,total,49,155,0,204
18-11-2021,Thiruvananthapuram,7,18,0,25
18-11-2021,Kollam,5,0,0,5
18-11-2021,Pathanamthitta,0,0,0,0
18-11-2021,Alappuzha,7,1,0,8
18-11-2021,Kottayam,5,0,0,5
18-11-2021,Idukki,3,22,0,25
18-11-2021,Ernakulam,4,66,0,70
18-11-2021,Thrissur,1,162,0,163
18-11-2021,Palakkad,5,1,0,6
18-11-2021,Malappuram,4,0,0,4
18-11-2021,Kozhikode,2,37,0,39
18-11-2021,Wayanad,0,0,0,0
18-11-2021,Kannur,8,14,0,22
18-11-2021,Kasaragod,0,0,0,0
18-11-2021,total,51,321,0,372
15-11-2021,Thiruvananthapuram,2,12,0,14
15-11-2021,Kollam,0,0,0,0
15-11-2021,Pathanamthitta,6,0,0,6
15-11-2021,Alappuzha,2,15,0,17
15-11-2021,Kottayam,0,0,0,0
15-11-2021,Idukki,6,16,0,22
15-11-2021,Ernakulam,29,4,0,33
15-11-2021,Thrissur,1,0,0,1
15-11-2021,Palakkad,1,10,0,11
15-11-2021,Malappuram,9,0,0,9
15-11-2021,Kozhikode,1,4,0,5
15-11-2021,Wayanad,0,0,0,0
15-11-2021,Kannur,0,2,0,2
15-11-2021,Kasaragod,0,7,0,7
15-11-2021,total,57,70,0,127
14-11-2021,Thiruvananthapuram,3,9,0,12
14-11-2021,Kollam,10,0,0,10
14-11-2021,Pathanamthitta,0,0,0,0
14-11-2021,Alappuzha,5,8,0,13
14-11-2021,Kottayam,8,0,0,8
14-11-2021,Idukki,0,0,0,0
14-11-2021,Ernakulam,8,2,0,10
14-11-2021,Thrissur,0,0,0,0
14-11-2021,Palakkad,6,0,0,6
14-11-2021,Malappuram,3,0,0,3
14-11-2021,Kozhikode,2,0,0,2
14-11-2021,Wayanad,0,0,0,0
14-11-2021,Kannur,0,0,0,0
14-11-2021,Kasaragod,1,0,0,1
14-11-2021,total,46,19,0,65
10-11-2021,Thiruvananthapuram,2,90,0,92
10-11-2021,Kollam,3,0,0,3
10-11-2021,Pathanamthitta,0,0,0,0
10-11-2021,Alappuzha,4,9,0,13
10-11-2021,Kottayam,15,14,0,29
10-11-2021,Idukki,0,9,0,9
10-11-2021,Ernakulam,6,63,0,69
10-11-2021,Thrissur,6,0,0,6
10-11-2021,Palakkad,2,0,0,2
10-11-2021,Malappuram,7,21,0,28
10-11-2021,Kozhikode,1,0,0,1
10-11-2021,Wayanad,0,0,0,0
10-11-2021,Kannur,0,0,0,0
10-11-2021,Kasaragod,2,5,0,7
10-11-2021,total,48,211,0,259
09-11-2021,Thiruvananthapuram,2,0,0,2
09-11-2021,Kollam,17,49,0,66
09-11-2021,Pathanamthitta,0,40,0,40
09-11-2021,Alappuzha,0,16,0,16
09-11-2021,Kottayam,0,28,0,28
09-11-2021,Idukki,1,0,0,1
09-11-2021,Ernakulam,3,124,0,127
09-11-2021,Thrissur,6,0,0,6
09-11-2021,Palakkad,3,7,0,10
09-11-2021,Malappuram,3,62,0,65
09-11-2021,Kozhikode,4,0,0,4
09-11-2021,Wayanad,4,0,0,4
09-11-2021,Kannur,0,0,0,0
09-11-2021,Kasaragod,4,11,0,15
09-11-2021,total,47,337,0,384
08-11-2021,Thiruvananthapuram,5,0,0,5
08-11-2021,Kollam,1,0,0,1
08-11-2021,Pathanamthitta,7,0,0,7
08-11-2021,Alappuzha,5,7,0,12
08-11-2021,Kottayam,12,58,0,70
08-11-2021,Idukki,0,0,0,0
08-11-2021,Ernakulam,2,44,0,46
08-11-2021,Thrissur,7,0,0,7
08-11-2021,Palakkad,0,5,0,5
08-11-2021,Malappuram,2,7,0,9
08-11-2021,Kozhikode,7,0,0,7
08-11-2021,Wayanad,3,0,0,3
08-11-2021,Kannur,28,61,0,89
08-11-2021,Kasaragod,1,0,0,1
08-11-2021,total,80,182,0,262
01-11-2021,Thiruvananthapuram,2,0,0,2
01-11-2021,Kollam,5,0,0,5
01-11-2021,Pathanamthitta,5,0,0,5
01-11-2021,Alappuzha,32,0,0,32
01-11-2021,Kottayam,4,0,0,4
01-11-2021,Idukki,4,0,0,4
01-11-2021,Ernakulam,2,34,5,41
01-11-2021,Thrissur,17,0,10,27
01-11-2021,Palakkad,2,0,4,6
01-11-2021,Malappuram,0,0,4,4
01-11-2021,Kozhikode,2,1,147,150
01-11-2021,Wayanad,3,11,2,16
01-11-2021,Kannur,0,12,60,72
01-11-2021,Kasaragod,0,0,0,0
01-11-2021,total,78,58,232,368
10-12-2021,Thiruvananthapuram,5,8,0,13
10-12-2021,Kollam,1,94,0,95
10-12-2021,Pathanamthitta,0,0,0,0
10-12-2021,Alappuzha,8,14,0,22
10-12-2021,Kottayam,2,10,0,12
10-12-2021,Idukki,0,0,0,0
10-12-2021,Ernakulam,7,14,0,21
10-12-2021,Thrissur,4,83,0,87
10-12-2021,Palakkad,2,24,0,26
10-12-2021,Malappuram,0,20,0,20
10-12-2021,Kozhikode,2,34,0,36
10-12-2021,Wayanad,0,0,0,0
10-12-2021,Kannur,0,4,0,4
10-12-2021,Kasaragod,0,4,0,4
10-12-2021,total,31,309,0,340
13-12-2021,Thiruvananthapuram,7,0,0,7
13-12-2021,Kollam,4,0,0,4
13-12-2021,Pathanamthitta,1,0,0,1
13-12-2021,Alappuzha,0,6,0,6
13-12-2021,Kottayam,1,89,0,90
13-12-2021,Idukki,0,5,0,5
13-12-2021,Ernakulam,5,0,0,5
13-12-2021,Thrissur,9,0,0,9
13-12-2021,Palakkad,3,6,0,9
13-12-2021,Malappuram,0,1,0,1
13-12-2021,Kozhikode,0,0,0,0
13-12-2021,Wayanad,0,0,0,0
13-12-2021,Kannur,6,58,0,64
13-12-2021,Kasaragod,2,0,0,2
13-12-2021,total,38,165,0,203
14-12-2021,Thiruvananthapuram,4,29,0,33
14-12-2021,Kollam,0,0,0,0
14-12-2021,Pathanamthitta,3,17,0,20
14-12-2021,Alappuzha,0,5,0,5
14-12-2021,Kottayam,0,3,0,3
14-12-2021,Idukki,7,16,0,23
14-12-2021,Ernakulam,0,0,0,0
14-12-2021,Thrissur,3,0,0,3
14-12-2021,Palakkad,3,15,0,18
14-12-2021,Malappuram,0,0,0,0
14-12-2021,Kozhikode,3,0,0,3
14-12-2021,Wayanad,3,0,0,3
14-12-2021,Kannur,2,49,0,51
14-12-2021,Kasaragod,0,12,0,12
14-12-2021,total,28,146,0,174
20-12-2021,Thiruvananthapuram,0,25,0,25
20-12-2021,Kollam,0,0,0,0
20-12-2021,Pathanamthitta,3,0,0,3
20-12-2021,Alappuzha,1,96,0,97
20-12-2021,Kottayam,1,61,0,62
20-12-2021,Idukki,6,0,0,6
20-12-2021,Ernakulam,0,32,0,32
20-12-2021,Thrissur,1,0,0,1
20-12-2021,Palakkad,1,0,0,1
20-12-2021,Malappuram,0,83,0,83
20-12-2021,Kozhikode,0,54,0,54
20-12-2021,Wayanad,1,0,0,1
20-12-2021,Kannur,0,54,0,54
20-12-2021,Kasaragod,0,0,0,0
20-12-2021,total,14,405,0,419
19-12-2021,Thiruvananthapuram,2,0,0,2
19-12-2021,Kollam,3,0,0,3
19-12-2021,Pathanamthitta,0,17,0,17
19-12-2021,Alappuzha,1,14,0,15
19-12-2021,Kottayam,2,0,0,2
19-12-2021,Idukki,0,0,0,0
19-12-2021,Ernakulam,0,10,0,10
19-12-2021,Thrissur,1,0,0,1
19-12-2021,Palakkad,1,0,0,1
19-12-2021,Malappuram,0,0,0,0
19-12-2021,Kozhikode,0,18,0,18
19-12-2021,Wayanad,0,0,0,0
19-12-2021,Kannur,1,26,0,27
19-12-2021,Kasaragod,0,0,0,0
19-12-2021,total,11,85,0,96
18-12-2021,Thiruvananthapuram,3,92,0,95
18-12-2021,Kollam,5,0,0,5
18-12-2021,Pathanamthitta,0,0,0,0
18-12-2021,Alappuzha,1,23,0,24
18-12-2021,Kottayam,2,0,0,2
18-12-2021,Idukki,0,0,0,0
18-12-2021,Ernakulam,7,0,0,7
18-12-2021,Thrissur,3,42,0,45
18-12-2021,Palakkad,4,0,0,4
18-12-2021,Malappuram,0,0,0,0
18-12-2021,Kozhikode,3,0,0,3
18-12-2021,Wayanad,0,18,0,18
18-12-2021,Kannur,12,0,0,12
18-12-2021,Kasaragod,3,0,0,3
18-12-2021,total,43,175,0,218
17-12-2021,Thiruvananthapuram,1,17,0,18
17-12-2021,Kollam,0,0,0,0
17-12-2021,Pathanamthitta,1,0,0,1
17-12-2021,Alappuzha,2,4,0,6
17-12-2021,Kottayam,2,34,0,36
17-12-2021,Idukki,5,0,0,5
17-12-2021,Ernakulam,4,0,0,4
17-12-2021,Thrissur,4,86,0,90
17-12-2021,Palakkad,0,0,0,0
17-12-2021,Malappuram,0,70,0,70
17-12-2021,Kozhikode,0,0,0,0
17-12-2021,Wayanad,2,2,0,4
17-12-2021,Kannur,1,8,0,9
17-12-2021,Kasaragod,0,0,0,0
17-12-2021,total,22,221,0,243
16-12-2021,Thiruvananthapuram,4,3,0,7
16-12-2021,Kollam,2,0,0,2
16-12-2021,Pathanamthitta,0,0,0,0
16-12-2021,Alappuzha,0,170,0,170
16-12-2021,Kottayam,1,0,0,1
16-12-2021,Idukki,0,19,0,19
16-12-2021,Ernakulam,15,0,0,15
16-12-2021,Thrissur,4,0,0,4
16-12-2021,Palakkad,1,5,0,6
16-12-2021,Malappuram,1,72,0,73
16-12-2021,Kozhikode,3,0,0,3
16-12-2021,Wayanad,0,0,0,0
16-12-2021,Kannur,5,15,0,20
16-12-2021,Kasaragod,0,0,0,0
16-12-2021,total,36,284,0,320
15-12-2021,Thiruvananthapuram,57,17,0,74
15-12-2021,Kollam,13,0,0,13
15-12-2021,Pathanamthitta,0,7,0,7
15-12-2021,Alappuzha,6,14,0,20
15-12-2021,Kottayam,1,19,0,20
15-12-2021,Idukki,10,0,0,10
15-12-2021,Ernakulam,13,2,0,15
15-12-2021,Thrissur,4,0,0,4
15-12-2021,Palakkad,0,17,0,17
15-12-2021,Malappuram,1,29,0,30
15-12-2021,Kozhikode,2,19,0,21
15-12-2021,Wayanad,8,33,0,41
15-12-2021,Kannur,9,0,0,9
15-12-2021,Kasaragod,1,0,0,1
15-12-2021,total,125,157,0,282
12-12-2021,Thiruvananthapuram,3,5,0,8
12-12-2021,Kollam,3,0,0,3
12-12-2021,Pathanamthitta,0,0,0,0
12-12-2021,Alappuzha,0,0,0,0
12-12-2021,Kottayam,6,65,0,71
12-12-2021,Idukki,0,0,0,0
12-12-2021,Ernakulam,0,39,0,39
12-12-2021,Thrissur,0,0,0,0
12-12-2021,Palakkad,1,0,0,1
12-12-2021,Malappuram,21,0,0,21
12-12-2021,Kozhikode,0,0,0,0
12-12-2021,Wayanad,0,0,0,0
12-12-2021,Kannur,0,0,0,0
12-12-2021,Kasaragod,0,0,0,0
12-12-2021,total,34,109,0,143
11-12-2021,Thiruvananthapuram,4,21,0,25
11-12-2021,Kollam,5,0,0,5
11-12-2021,Pathanamthitta,1,0,0,1
11-12-2021,Alappuzha,5,0,0,5
11-12-2021,Kottayam,3,34,0,37
11-12-2021,Idukki,0,0,0,0
11-12-2021,Ernakulam,21,44,0,65
11-12-2021,Thrissur,0,85,0,85
11-12-2021,Palakkad,1,1,0,2
11-12-2021,Malappuram,8,0,0,8
11-12-2021,Kozhikode,2,0,0,2
11-12-2021,Wayanad,0,10,0,10
11-12-2021,Kannur,0,0,0,0
11-12-2021,Kasaragod,0,0,0,0
11-12-2021,total,50,195,0,245
21-12-2021,Thiruvananthapuram,6,34,0,40
21-12-2021,Kollam,9,0,0,9
21-12-2021,Pathanamthitta,1,0,0,1
21-12-2021,Alappuzha,1,25,0,26
21-12-2021,Kottayam,1,18,0,19
21-12-2021,Idukki,1,36,0,37
21-12-2021,Ernakulam,0,28,0,28
21-12-2021,Thrissur,0,0,0,0
21-12-2021,Palakkad,2,2,0,4
21-12-2021,Malappuram,3,45,0,48
21-12-2021,Kozhikode,3,0,0,3
21-12-2021,Wayanad,0,5,0,5
21-12-2021,Kannur,6,7,0,13
21-12-2021,Kasaragod,0,0,0,0
21-12-2021,total,33,200,0,233
22-12-2021,Thiruvananthapuram,0,32,0,32
22-12-2021,Kollam,1,167,0,168
22-12-2021,Pathanamthitta,5,0,0,5
22-12-2021,Alappuzha,0,6,0,6
22-12-2021,Kottayam,3,33,0,36
22-12-2021,Idukki,0,16,0,16
22-12-2021,Ernakulam,7,81,0,88
22-12-2021,Thrissur,4,0,0,4
22-12-2021,Palakkad,2,10,0,12
22-12-2021,Malappuram,0,1,0,1
22-12-2021,Kozhikode,2,0,0,2
22-12-2021,Wayanad,0,0,0,0
22-12-2021,Kannur,12,1,0,13
22-12-2021,Kasaragod,0,0,0,0
22-12-2021,total,36,347,0,383
23-12-2021,Thiruvananthapuram,5,4,0,9
23-12-2021,Kollam,2,0,0,2
23-12-2021,Pathanamthitta,1,0,0,1
23-12-2021,Alappuzha,0,61,0,61
23-12-2021,Kottayam,10,0,0,10
23-12-2021,Idukki,6,0,0,6
23-12-2021,Ernakulam,8,0,0,8
23-12-2021,Thrissur,2,116,0,118
23-12-2021,Palakkad,2,34,0,36
23-12-2021,Malappuram,0,47,0,47
23-12-2021,Kozhikode,0,0,0,0
23-12-2021,Wayanad,4,0,0,4
23-12-2021,Kannur,14,7,0,21
23-12-2021,Kasaragod,0,0,0,0
23-12-2021,total,54,269,0,323
24-12-2021,Thiruvananthapuram,4,0,0,4
24-12-2021,Kollam,0,0,0,0
24-12-2021,Pathanamthitta,1,22,0,23
24-12-2021,Alappuzha,0,32,0,32
24-12-2021,Kottayam,2,0,0,2
24-12-2021,Idukki,0,0,0,0
24-12-2021,Ernakulam,11,0,0,11
24-12-2021,Thrissur,3,110,0,113
24-12-2021,Palakkad,0,47,0,47
24-12-2021,Malappuram,3,66,0,69
24-12-2021,Kozhikode,2,0,0,2
24-12-2021,Wayanad,0,0,0,0
24-12-2021,Kannur,5,34,0,39
24-12-2021,Kasaragod,0,0,0,0
24-12-2021,total,31,311,0,342
26-12-2021,Thiruvananthapuram,0,0,0,0
26-12-2021,Kollam,0,0,0,0
26-12-2021,Pathanamthitta,0,0,0,0
26-12-2021,Alappuzha,6,166,0,172
26-12-2021,Kottayam,3,0,0,3
26-12-2021,Idukki,0,0,0,0
26-12-2021,Ernakulam,3,34,0,37
26-12-2021,Thrissur,0,0,0,0
26-12-2021,Palakkad,0,37,0,37
26-12-2021,Malappuram,0,15,0,15
26-12-2021,Kozhikode,0,0,0,0
26-12-2021,Wayanad,0,0,0,0
26-12-2021,Kannur,4,0,0,4
26-12-2021,Kasaragod,0,0,0,0
26-12-2021,total,16,252,0,268
25-12-2021,Thiruvananthapuram,2,4,0,6
25-12-2021,Kollam,5,0,0,5
25-12-2021,Pathanamthitta,0,21,0,21
25-12-2021,Alappuzha,1,69,0,70
25-12-2021,Kottayam,0,0,0,0
25-12-2021,Idukki,0,0,0,0
25-12-2021,Ernakulam,2,3,0,5
25-12-2021,Thrissur,1,0,0,1
25-12-2021,Palakkad,0,4,0,4
25-12-2021,Malappuram,0,3,0,3
25-12-2021,Kozhikode,0,0,0,0
25-12-2021,Wayanad,0,0,0,0
25-12-2021,Kannur,0,0,0,0
25-12-2021,Kasaragod,0,0,0,0
25-12-2021,total,11,104,0,115
27-12-2021,Thiruvananthapuram,5,0,0,5
27-12-2021,Kollam,0,0,0,0
27-12-2021,Pathanamthitta,8,0,0,8
27-12-2021,Alappuzha,0,5,0,5
27-12-2021,Kottayam,0,106,0,106
27-12-2021,Idukki,0,0,0,0
27-12-2021,Ernakulam,2,58,0,60
27-12-2021,Thrissur,0,0,0,0
27-12-2021,Palakkad,2,22,0,24
27-12-2021,Malappuram,0,0,0,0
27-12-2021,Kozhikode,2,0,0,2
27-12-2021,Wayanad,2,10,0,12
27-12-2021,Kannur,2,12,0,14
27-12-2021,Kasaragod,0,0,0,0
27-12-2021,total,23,213,0,236
28-12-2021,Thiruvananthapuram,7,0,0,7
28-12-2021,Kollam,5,0,0,5
28-12-2021,Pathanamthitta,0,0,0,0
28-12-2021,Alappuzha,0,73,0,73
28-12-2021,Kottayam,3,4,0,7
28-12-2021,Idukki,1,0,0,1
28-12-2021,Ernakulam,5,42,0,47
28-12-2021,Thrissur,0,0,0,0
28-12-2021,Palakkad,0,26,0,26
28-12-2021,Malappuram,0,52,0,52
28-12-2021,Kozhikode,3,0,0,3
28-12-2021,Wayanad,0,0,0,0
28-12-2021,Kannur,6,9,0,15
28-12-2021,Kasaragod,8,0,0,8
28-12-2021,total,38,206,0,244
29-12-2021,Thiruvananthapuram,2,0,0,2
29-12-2021,Kollam,3,0,0,3
29-12-2021,Pathanamthitta,1,0,0,1
29-12-2021,Alappuzha,0,1,0,1
29-12-2021,Kottayam,2,46,0,48
29-12-2021,Idukki,0,38,0,38
29-12-2021,Ernakulam,1,66,0,67
29-12-2021,Thrissur,1,0,0,1
29-12-2021,Palakkad,1,11,0,12
29-12-2021,Malappuram,0,5,0,5
29-12-2021,Kozhikode,1,0,0,1
29-12-2021,Wayanad,0,0,0,0
29-12-2021,Kannur,0,18,0,18
29-12-2021,Kasaragod,0,14,0,14
29-12-2021,total,12,199,0,211
30-12-2021,Thiruvananthapuram,5,6,0,11
30-12-2021,Kollam,2,0,0,2
30-12-2021,Pathanamthitta,0,29,0,29
30-12-2021,Alappuzha,0,4,0,4
30-12-2021,Kottayam,2,0,0,2
30-12-2021,Idukki,0,0,0,0
30-12-2021,Ernakulam,0,0,0,0
30-12-2021,Thrissur,2,0,0,2
30-12-2021,Palakkad,1,14,0,15
30-12-2021,Malappuram,0,75,0,75
30-12-2021,Kozhikode,1,0,0,1
30-12-2021,Wayanad,0,0,0,0
30-12-2021,Kannur,2,9,0,11
30-12-2021,Kasaragod,0,12,0,12
30-12-2021,total,15,149,0,164
31-12-2021,Thiruvananthapuram,3,12,0,15
31-12-2021,Kollam,0,179,0,179
31-12-2021,Pathanamthitta,1,0,0,1
31-12-2021,Alappuzha,1,9,0,10
31-12-2021,Kottayam,2,0,0,2
31-12-2021,Idukki,0,0,0,0
31-12-2021,Ernakulam,0,0,0,0
31-12-2021,Thrissur,0,29,0,29
31-12-2021,Palakkad,0,66,0,66
31-12-2021,Malappuram,0,15,0,15
31-12-2021,Kozhikode,0,2,0,2
31-12-2021,Wayanad,2,0,0,2
31-12-2021,Kannur,1,18,0,19
31-12-2021,Kasaragod,1,12,0,13
31-12-2021,total,11,342,0,353
01-01-2022,Thiruvananthapuram,2,7,0,9
01-01-2022,Kollam,3,10,0,13
01-01-2022,Pathanamthitta,2,0,0,2
01-01-2022,Alappuzha,0,0,0,0
01-01-2022,Kottayam,0,4,0,4
01-01-2022,Idukki,3,0,0,3
01-01-2022,Ernakulam,6,0,0,6
01-01-2022,Thrissur,3,102,0,105
01-01-2022,Palakkad,1,8,0,9
01-01-2022,Malappuram,0,1,0,1
01-01-2022,Kozhikode,1,71,0,72
01-01-2022,Wayanad,0,0,0,0
01-01-2022,Kannur,0,0,0,0
01-01-2022,Kasaragod,1,16,0,17
01-01-2022,total,22,219,0,241
02-01-2022,Thiruvananthapuram,0,1,0,1
02-01-2022,Kollam,1,0,0,1
02-01-2022,Pathanamthitta,O,0,0,0
02-01-2022,Alappuzha,0,0,0,0
02-01-2022,Kottayam,3,13,0,16
02-01-2022,Idukki,3,0,0,3
02-01-2022,Ernakulam,3,0,0,3
02-01-2022,Thrissur,0,0,0,0
02-01-2022,Palakkad,1,17,0,18
02-01-2022,Malappuram,0,0,0,0
02-01-2022,Kozhikode,0,35,0,35
02-01-2022,Wayanad,0,0,0,0
02-01-2022,Kannur,1,0,0,1
02-01-2022,Kasaragod,0,0,0,0
02-01-2022,total,12,66,0,78
03-01-2022,Thiruvananthapuram,4,5,0,9
03-01-2022,Kollam,6,0,0,6
03-01-2022,Pathanamthitta,0,0,0,0
03-01-2022,Alappuzha,0,1,0,1
03-01-2022,Kottayam,0,14,0,14
03-01-2022,Idukki,0,0,0,0
03-01-2022,Ernakulam,2,0,0,2
03-01-2022,Thrissur,1,0,0,1
03-01-2022,Palakkad,1,0,0,1
03-01-2022,Malappuram,0,17,0,17
03-01-2022,Kozhikode,8,0,0,8
03-01-2022,Wayanad,1,0,0,1
03-01-2022,Kannur,7,0,0,7
03-01-2022,Kasaragod,0,4,0,4
03-01-2022,total,30,41,0,71
04-01-2022,Thiruvananthapuram,5,37,0,42
04-01-2022,Kollam,2,0,0,2
04-01-2022,Pathanamthitta,5,0,0,0
04-01-2022,Alappuzha,0,193,0,193
04-01-2022,Kottayam,2,15,0,17
04-01-2022,Idukki,0,0,0,0
04-01-2022,Ernakulam,0,8,0,8
04-01-2022,Thrissur,1,0,0,1
04-01-2022,Palakkad,0,13,0,13
04-01-2022,Malappuram,10,51,0,61
04-01-2022,Kozhikode,4,0,0,4
04-01-2022,Wayanad,0,25,0,25
04-01-2022,Kannur,1,77,0,78
04-01-2022,Kasaragod,0,4,0,4
04-01-2022,total,30,423,0,453
05-01-2022,Thiruvananthapuram,2,85,0,87
05-01-2022,Kollam,2,0,0,2
05-01-2022,Pathanamthitta,0,0,0,0
05-01-2022,Alappuzha,0,35,0,35
05-01-2022,Kottayam,0,8,0,8
05-01-2022,Idukki,0,0,0,0
05-01-2022,Ernakulam,4,77,0,81
05-01-2022,Thrissur,0,0,0,0
05-01-2022,Palakkad,4,1,0,5
05-01-2022,Malappuram,0,0,0,0
05-01-2022,Kozhikode,11,0,0,11
05-01-2022,Wayanad,0,0,0,0
05-01-2022,Kannur,6,5,0,11
05-01-2022,Kasaragod,0,18,0,18
05-01-2022,total,29,229,0,258
